# Существительное

N:0:pA	NCXXNXXAP
N:0:pD	NCXXNXXDP
N:0:pG	NCXXNXXGP
N:0:pI	NCXXNXXIP
N:0:pL	NCXXNXXLP
N:0:pN	NCXXNXXNP
	
N:c:pA	NCXXNCXAP
N:c:pD	NCXXNCXDP
N:c:pG	NCXXNCXGP
N:c:pI	NCXXNCXIP
N:c:pL	NCXXNCXLP
N:c:pN	NCXXNCXNP
	
N:c:sA	NCXXNCXAS
N:c:sD	NCXXNCXDS
N:c:sG	NCXXNCXGS
N:c:sI	NCXXNCXIS
N:c:sL	NCXXNCXLS
N:c:sN	NCXXNCXNS
	
N:f:pA	NCXXNFXAP
N:f:pD	NCXXNFXDP
N:f:pG	NCXXNFXGP
N:f:pI	NCXXNFXIP
N:f:pL	NCXXNFXLP
N:f:pN	NCXXNFXNP
	
N:f:sA	NCXXNFXAS
N:f:sD	NCXXNFXDS
N:f:sG	NCXXNFXGS
N:f:sI	NCXXNFXIS
N:f:sL	NCXXNFXLS
N:f:sN	NCXXNFXNS
	
N:m:pA	NCXXNMXAP
N:m:pD	NCXXNMXDP
N:m:pG	NCXXNMXGP
N:m:pI	NCXXNMXIP
N:m:pL	NCXXNMXLP
N:m:pN	NCXXNMXNP
N:m:pV	NCXXNMXVP
	
N:m:sA	NCXXNMXAS
N:m:sD	NCXXNMXDS
N:m:sG	NCXXNMXGS
N:m:sI	NCXXNMXIS
N:m:sL	NCXXNMXLS
N:m:sN	NCXXNMXNS
N:m:sV	NCXXNMXVS
	
N:n:pA	NCXXNNXAP
N:n:pD	NCXXNNXDP
N:n:pG	NCXXNNXGP
N:n:pI	NCXXNNXIP
N:n:pL	NCXXNNXLP
N:n:pN	NCXXNNXNP
	
N:n:sA	NCXXNNXAS
N:n:sD	NCXXNNXDS
N:n:sG	NCXXNNXGS
N:n:sI	NCXXNNXIS
N:n:sL	NCXXNNXLS
N:n:sN	NCXXNNXNS
	
N:subst:f:pA	NCXXNF5AP
N:subst:f:pD	NCXXNF5DP
N:subst:f:pG	NCXXNF5GP
N:subst:f:pI	NCXXNF5IP
N:subst:f:pL	NCXXNF5LP
N:subst:f:pN	NCXXNF5NP
	
N:subst:f:sA	NCXXNF5AS
N:subst:f:sD	NCXXNF5DS
N:subst:f:sG	NCXXNF5GS
N:subst:f:sI	NCXXNF5IS
N:subst:f:sL	NCXXNF5LS
N:subst:f:sN	NCXXNF5NS
	
N:subst:m:pA	NCXXNM5AP
N:subst:m:pD	NCXXNM5DP
N:subst:m:pG	NCXXNM5GP
N:subst:m:pI	NCXXNM5IP
N:subst:m:pL	NCXXNM5LP
N:subst:m:pN	NCXXNM5NP
	
N:subst:m:sA	NCXXNM5AS
N:subst:m:sD	NCXXNM5DS
N:subst:m:sG	NCXXNM5GS
N:subst:m:sI	NCXXNM5IS
N:subst:m:sL	NCXXNM5LS
N:subst:m:sN	NCXXNM5NS
	
N:subst:n:pA	NCXXNN5AP
N:subst:n:pD	NCXXNN5DP
N:subst:n:pG	NCXXNN5GP
N:subst:n:pI	NCXXNN5IP
N:subst:n:pL	NCXXNN5LP
N:subst:n:pN	NCXXNN5NP
	
N:subst:n:sA	NCXXNN5AS
N:subst:n:sD	NCXXNN5DS
N:subst:n:sG	NCXXNN5GS
N:subst:n:sI	NCXXNN5IS
N:subst:n:sL	NCXXNN5LS
N:subst:n:sN	NCXXNN5NS

N:anim:0:pA	NCAXNXXAP
N:anim:0:pD	NCAXNXXDP
N:anim:0:pG	NCAXNXXGP
N:anim:0:pI	NCAXNXXIP
N:anim:0:pL	NCAXNXXLP
N:anim:0:pN	NCAXNXXNP
	
N:anim:c:pA	NCAXNCXAP
N:anim:c:pD	NCAXNCXDP
N:anim:c:pG	NCAXNCXGP
N:anim:c:pI	NCAXNCXIP
N:anim:c:pL	NCAXNCXLP
N:anim:c:pN	NCAXNCXNP
	
N:anim:c:sA	NCAXNCXAS
N:anim:c:sD	NCAXNCXDS
N:anim:c:sG	NCAXNCXGS
N:anim:c:sI	NCAXNCXIS
N:anim:c:sL	NCAXNCXLS
N:anim:c:sN	NCAXNCXNS
	
N:anim:f:pA	NCAXNFXAP
N:anim:f:pD	NCAXNFXDP
N:anim:f:pG	NCAXNFXGP
N:anim:f:pI	NCAXNFXIP
N:anim:f:pL	NCAXNFXLP
N:anim:f:pN	NCAXNFXNP
	
N:anim:f:sA	NCAXNFXAS
N:anim:f:sD	NCAXNFXDS
N:anim:f:sG	NCAXNFXGS
N:anim:f:sI	NCAXNFXIS
N:anim:f:sL	NCAXNFXLS
N:anim:f:sN	NCAXNFXNS
	
N:anim:m:pA	NCAXNMXAP
N:anim:m:pD	NCAXNMXDP
N:anim:m:pG	NCAXNMXGP
N:anim:m:pI	NCAXNMXIP
N:anim:m:pL	NCAXNMXLP
N:anim:m:pN	NCAXNMXNP
	
N:anim:m:sA	NCAXNMXAS
N:anim:m:sD	NCAXNMXDS
N:anim:m:sG	NCAXNMXGS
N:anim:m:sI	NCAXNMXIS
N:anim:m:sL	NCAXNMXLS
N:anim:m:sN	NCAXNMXNS
N:anim:m:sV	NCAXNMXVS
	
N:anim:n:pA	NCAXNNXAP
N:anim:n:pD	NCAXNNXDP
N:anim:n:pG	NCAXNNXGP
N:anim:n:pI	NCAXNNXIP
N:anim:n:pL	NCAXNNXLP
N:anim:n:pN	NCAXNNXNP
	
N:anim:n:sA	NCAXNNXAS
N:anim:n:sD	NCAXNNXDS
N:anim:n:sG	NCAXNNXGS
N:anim:n:sI	NCAXNNXIS
N:anim:n:sL	NCAXNNXLS
N:anim:n:sN	NCAXNNXNS
	
N:anim:subst:f:pA	NCAXNF5AP
N:anim:subst:f:pD	NCAXNF5DP
N:anim:subst:f:pG	NCAXNF5GP
N:anim:subst:f:pI	NCAXNF5IP
N:anim:subst:f:pL	NCAXNF5LP
N:anim:subst:f:pN	NCAXNF5NP
	
N:anim:subst:f:sA	NCAXNF5AS
N:anim:subst:f:sD	NCAXNF5DS
N:anim:subst:f:sG	NCAXNF5GS
N:anim:subst:f:sI	NCAXNF5IS
N:anim:subst:f:sL	NCAXNF5LS
N:anim:subst:f:sN	NCAXNF5NS
	
N:anim:subst:m:pA	NCAXNM5AP
N:anim:subst:m:pD	NCAXNM5DP
N:anim:subst:m:pG	NCAXNM5GP
N:anim:subst:m:pI	NCAXNM5IP
N:anim:subst:m:pL	NCAXNM5LP
N:anim:subst:m:pN	NCAXNM5NP
	
N:anim:subst:m:sA	NCAXNM5AS
N:anim:subst:m:sD	NCAXNM5DS
N:anim:subst:m:sG	NCAXNM5GS
N:anim:subst:m:sI	NCAXNM5IS
N:anim:subst:m:sL	NCAXNM5LS
N:anim:subst:m:sN	NCAXNM5NS
	
N:anim:subst:n:pA	NCAXNN5AP
N:anim:subst:n:pD	NCAXNN5DP
N:anim:subst:n:pG	NCAXNN5GP
N:anim:subst:n:pI	NCAXNN5IP
N:anim:subst:n:pL	NCAXNN5LP
N:anim:subst:n:pN	NCAXNN5NP
	
N:anim:subst:n:sA	NCAXNN5AS
N:anim:subst:n:sD	NCAXNN5DS
N:anim:subst:n:sG	NCAXNN5GS
N:anim:subst:n:sI	NCAXNN5IS
N:anim:subst:n:sL	NCAXNN5LS
N:anim:subst:n:sN	NCAXNN5NS
	
N:inanim:0:pA	NCIXNXXAP
N:inanim:0:pD	NCIXNXXDP
N:inanim:0:pG	NCIXNXXGP
N:inanim:0:pI	NCIXNXXIP
N:inanim:0:pL	NCIXNXXLP
N:inanim:0:pN	NCIXNXXNP
	
N:inanim:c:pA	NCIXNCXAP
N:inanim:c:pD	NCIXNCXDP
N:inanim:c:pG	NCIXNCXGP
N:inanim:c:pI	NCIXNCXIP
N:inanim:c:pL	NCIXNCXLP
N:inanim:c:pN	NCIXNCXNP
	
N:inanim:c:sA	NCIXNCXAS
N:inanim:c:sD	NCIXNCXDS
N:inanim:c:sG	NCIXNCXGS
N:inanim:c:sI	NCIXNCXIS
N:inanim:c:sL	NCIXNCXLS
N:inanim:c:sN	NCIXNCXNS
	
N:inanim:f:pA	NCIXNFXAP
N:inanim:f:pD	NCIXNFXDP
N:inanim:f:pG	NCIXNFXGP
N:inanim:f:pI	NCIXNFXIP
N:inanim:f:pL	NCIXNFXLP
N:inanim:f:pN	NCIXNFXNP
	
N:inanim:f:sA	NCIXNFXAS
N:inanim:f:sD	NCIXNFXDS
N:inanim:f:sG	NCIXNFXGS
N:inanim:f:sI	NCIXNFXIS
N:inanim:f:sL	NCIXNFXLS
N:inanim:f:sN	NCIXNFXNS
	
N:inanim:m:pA	NCIXNMXAP
N:inanim:m:pD	NCIXNMXDP
N:inanim:m:pG	NCIXNMXGP
N:inanim:m:pI	NCIXNMXIP
N:inanim:m:pL	NCIXNMXLP
N:inanim:m:pN	NCIXNMXNP
	
N:inanim:m:sA	NCIXNMXAS
N:inanim:m:sD	NCIXNMXDS
N:inanim:m:sG	NCIXNMXGS
N:inanim:m:sI	NCIXNMXIS
N:inanim:m:sL	NCIXNMXLS
N:inanim:m:sN	NCIXNMXNS
N:inanim:m:sV	NCIXNMXVS
	
N:inanim:n:pA	NCIXNNXAP
N:inanim:n:pD	NCIXNNXDP
N:inanim:n:pG	NCIXNNXGP
N:inanim:n:pI	NCIXNNXIP
N:inanim:n:pL	NCIXNNXLP
N:inanim:n:pN	NCIXNNXNP
	
N:inanim:n:sA	NCIXNNXAS
N:inanim:n:sD	NCIXNNXDS
N:inanim:n:sG	NCIXNNXGS
N:inanim:n:sI	NCIXNNXIS
N:inanim:n:sL	NCIXNNXLS
N:inanim:n:sN	NCIXNNXNS
	
N:inanim:subst:f:pA	NCIXNF5AP
N:inanim:subst:f:pD	NCIXNF5DP
N:inanim:subst:f:pG	NCIXNF5GP
N:inanim:subst:f:pI	NCIXNF5IP
N:inanim:subst:f:pL	NCIXNF5LP
N:inanim:subst:f:pN	NCIXNF5NP
	
N:inanim:subst:f:sA	NCIXNF5AS
N:inanim:subst:f:sD	NCIXNF5DS
N:inanim:subst:f:sG	NCIXNF5GS
N:inanim:subst:f:sI	NCIXNF5IS
N:inanim:subst:f:sL	NCIXNF5LS
N:inanim:subst:f:sN	NCIXNF5NS
	
N:inanim:subst:m:pA	NCIXNM5AP
N:inanim:subst:m:pD	NCIXNM5DP
N:inanim:subst:m:pG	NCIXNM5GP
N:inanim:subst:m:pI	NCIXNM5IP
N:inanim:subst:m:pL	NCIXNM5LP
N:inanim:subst:m:pN	NCIXNM5NP
	
N:inanim:subst:m:sA	NCIXNM5AS
N:inanim:subst:m:sD	NCIXNM5DS
N:inanim:subst:m:sG	NCIXNM5GS
N:inanim:subst:m:sI	NCIXNM5IS
N:inanim:subst:m:sL	NCIXNM5LS
N:inanim:subst:m:sN	NCIXNM5NS
	
N:inanim:subst:n:pA	NCIXNN5AP
N:inanim:subst:n:pD	NCIXNN5DP
N:inanim:subst:n:pG	NCIXNN5GP
N:inanim:subst:n:pI	NCIXNN5IP
N:inanim:subst:n:pL	NCIXNN5LP
N:inanim:subst:n:pN	NCIXNN5NP
	
N:inanim:subst:n:sA	NCIXNN5AS
N:inanim:subst:n:sD	NCIXNN5DS
N:inanim:subst:n:sG	NCIXNN5GS
N:inanim:subst:n:sI	NCIXNN5IS
N:inanim:subst:n:sL	NCIXNN5LS
N:inanim:subst:n:sN	NCIXNN5NS

NP_fn:f:sA	NPXXNFXAS
NP_fn:f:sD	NPXXNFXDS
NP_fn:f:sG	NPXXNFXGS
NP_fn:f:sI	NPXXNFXIS
NP_fn:f:sL	NPXXNFXLS
NP_fn:f:sN	NPXXNFXNS
	
NP_fn:m:sA	NPXXNMXAS
NP_fn:m:sD	NPXXNMXDS
NP_fn:m:sG	NPXXNMXGS
NP_fn:m:sI	NPXXNMXIS
NP_fn:m:sL	NPXXNMXLS
NP_fn:m:sN	NPXXNMXNS
	
NP_mn:f:sA	NPXXNFXAS
NP_mn:f:sD	NPXXNFXDS
NP_mn:f:sG	NPXXNFXGS
NP_mn:f:sI	NPXXNFXIS
NP_mn:f:sL	NPXXNFXLS
NP_mn:f:sN	NPXXNFXNS
	
NP_mn:m:sA	NPXXNMXAS
NP_mn:m:sD	NPXXNMXDS
NP_mn:m:sG	NPXXNMXGS
NP_mn:m:sI	NPXXNMXIS
NP_mn:m:sL	NPXXNMXLS
NP_mn:m:sN	NPXXNMXNS
	
NP_surn:0:pA	NPXXNXXAP
NP_surn:0:pD	NPXXNXXDP
NP_surn:0:pG	NPXXNXXGP
NP_surn:0:pI	NPXXNXXIP
NP_surn:0:pL	NPXXNXXLP
NP_surn:0:pN	NPXXNXXNP
	
NP_surn:f:sA	NPXXNFXAS
NP_surn:f:sD	NPXXNFXDS
NP_surn:f:sG	NPXXNFXGS
NP_surn:f:sI	NPXXNFXIS
NP_surn:f:sL	NPXXNFXLS
NP_surn:f:sN	NPXXNFXNS
	
NP_surn:m:sA	NPXXNMXAS
NP_surn:m:sD	NPXXNMXDS
NP_surn:m:sG	NPXXNMXGS
NP_surn:m:sI	NPXXNMXIS
NP_surn:m:sL	NPXXNMXLS
NP_surn:m:sN	NPXXNMXNS

NP_surn	NPXXNXXXX

NP_top_country:0:pA	NPXXNXXAP
NP_top_country:0:pD	NPXXNXXDP
NP_top_country:0:pG	NPXXNXXGP
NP_top_country:0:pI	NPXXNXXIP
NP_top_country:0:pL	NPXXNXXLP
NP_top_country:0:pN	NPXXNXXNP
	
NP_top_country:f:sA	NPXXNFXAS
NP_top_country:f:sD	NPXXNFXDS
NP_top_country:f:sG	NPXXNFXGS
NP_top_country:f:sI	NPXXNFXIS
NP_top_country:f:sL	NPXXNFXLS
NP_top_country:f:sN	NPXXNFXNS
	
NP_top_country:m:sA	NPXXNMXAS
NP_top_country:m:sD	NPXXNMXDS
NP_top_country:m:sG	NPXXNMXGS
NP_top_country:m:sI	NPXXNMXIS
NP_top_country:m:sL	NPXXNMXLS
NP_top_country:m:sN	NPXXNMXNS

NP_top_country:n:sA	NPXXNNXAS
NP_top_country:n:sD	NPXXNNXDS
NP_top_country:n:sG	NPXXNNXGS
NP_top_country:n:sI	NPXXNNXIS
NP_top_country:n:sL	NPXXNNXLS
NP_top_country:n:sN	NPXXNNXNS

NP_top_country	NPXXNXXXX

NP_top_distr:0:pA	NPXXNXXAP
NP_top_distr:0:pD	NPXXNXXDP
NP_top_distr:0:pG	NPXXNXXGP
NP_top_distr:0:pI	NPXXNXXIP
NP_top_distr:0:pL	NPXXNXXLP
NP_top_distr:0:pN	NPXXNXXNP
	
NP_top_distr:f:sA	NPXXNFXAS
NP_top_distr:f:sD	NPXXNFXDS
NP_top_distr:f:sG	NPXXNFXGS
NP_top_distr:f:sI	NPXXNFXIS
NP_top_distr:f:sL	NPXXNFXLS
NP_top_distr:f:sN	NPXXNFXNS
	
NP_top_distr:m:sA	NPXXNMXAS
NP_top_distr:m:sD	NPXXNMXDS
NP_top_distr:m:sG	NPXXNMXGS
NP_top_distr:m:sI	NPXXNMXIS
NP_top_distr:m:sL	NPXXNMXLS
NP_top_distr:m:sN	NPXXNMXNS

NP_top_distr:n:sA	NPXXNNXAS
NP_top_distr:n:sD	NPXXNNXDS
NP_top_distr:n:sG	NPXXNNXGS
NP_top_distr:n:sI	NPXXNNXIS
NP_top_distr:n:sL	NPXXNNXLS
NP_top_distr:n:sN	NPXXNNXNS

NP_top_distr	NPXXNXXXX

NP_top_isle:0:pA	NPXXNXXAP
NP_top_isle:0:pD	NPXXNXXDP
NP_top_isle:0:pG	NPXXNXXGP
NP_top_isle:0:pI	NPXXNXXIP
NP_top_isle:0:pL	NPXXNXXLP
NP_top_isle:0:pN	NPXXNXXNP
	
NP_top_isle:f:sA	NPXXNFXAS
NP_top_isle:f:sD	NPXXNFXDS
NP_top_isle:f:sG	NPXXNFXGS
NP_top_isle:f:sI	NPXXNFXIS
NP_top_isle:f:sL	NPXXNFXLS
NP_top_isle:f:sN	NPXXNFXNS
	
NP_top_isle:m:sA	NPXXNMXAS
NP_top_isle:m:sD	NPXXNMXDS
NP_top_isle:m:sG	NPXXNMXGS
NP_top_isle:m:sI	NPXXNMXIS
NP_top_isle:m:sL	NPXXNMXLS
NP_top_isle:m:sN	NPXXNMXNS

NP_top_isle:n:sA	NPXXNNXAS
NP_top_isle:n:sD	NPXXNNXDS
NP_top_isle:n:sG	NPXXNNXGS
NP_top_isle:n:sI	NPXXNNXIS
NP_top_isle:n:sL	NPXXNNXLS
NP_top_isle:n:sN	NPXXNNXNS

NP_top_isle	NPXXNXXXX

NP_top_lake:0:pA	NPXXNXXAP
NP_top_lake:0:pD	NPXXNXXDP
NP_top_lake:0:pG	NPXXNXXGP
NP_top_lake:0:pI	NPXXNXXIP
NP_top_lake:0:pL	NPXXNXXLP
NP_top_lake:0:pN	NPXXNXXNP
	
NP_top_lake:f:sA	NPXXNFXAS
NP_top_lake:f:sD	NPXXNFXDS
NP_top_lake:f:sG	NPXXNFXGS
NP_top_lake:f:sI	NPXXNFXIS
NP_top_lake:f:sL	NPXXNFXLS
NP_top_lake:f:sN	NPXXNFXNS
	
NP_top_lake:m:sA	NPXXNMXAS
NP_top_lake:m:sD	NPXXNMXDS
NP_top_lake:m:sG	NPXXNMXGS
NP_top_lake:m:sI	NPXXNMXIS
NP_top_lake:m:sL	NPXXNMXLS
NP_top_lake:m:sN	NPXXNMXNS

NP_top_lake:n:sA	NPXXNNXAS
NP_top_lake:n:sD	NPXXNNXDS
NP_top_lake:n:sG	NPXXNNXGS
NP_top_lake:n:sI	NPXXNNXIS
NP_top_lake:n:sL	NPXXNNXLS
NP_top_lake:n:sN	NPXXNNXNS

NP_top_lake	NPXXNXXXX

NP_top_mount:0:pA	NPXXNXXAP
NP_top_mount:0:pD	NPXXNXXDP
NP_top_mount:0:pG	NPXXNXXGP
NP_top_mount:0:pI	NPXXNXXIP
NP_top_mount:0:pL	NPXXNXXLP
NP_top_mount:0:pN	NPXXNXXNP
	
NP_top_mount:f:sA	NPXXNFXAS
NP_top_mount:f:sD	NPXXNFXDS
NP_top_mount:f:sG	NPXXNFXGS
NP_top_mount:f:sI	NPXXNFXIS
NP_top_mount:f:sL	NPXXNFXLS
NP_top_mount:f:sN	NPXXNFXNS
	
NP_top_mount:m:sA	NPXXNMXAS
NP_top_mount:m:sD	NPXXNMXDS
NP_top_mount:m:sG	NPXXNMXGS
NP_top_mount:m:sI	NPXXNMXIS
NP_top_mount:m:sL	NPXXNMXLS
NP_top_mount:m:sN	NPXXNMXNS

NP_top_mount:n:sA	NPXXNNXAS
NP_top_mount:n:sD	NPXXNNXDS
NP_top_mount:n:sG	NPXXNNXGS
NP_top_mount:n:sI	NPXXNNXIS
NP_top_mount:n:sL	NPXXNNXLS
NP_top_mount:n:sN	NPXXNNXNS

NP_top_mount	NPXXNXXXX

NP_top_reg:0:pA	NPXXNXXAP
NP_top_reg:0:pD	NPXXNXXDP
NP_top_reg:0:pG	NPXXNXXGP
NP_top_reg:0:pI	NPXXNXXIP
NP_top_reg:0:pL	NPXXNXXLP
NP_top_reg:0:pN	NPXXNXXNP
	
NP_top_reg:f:sA	NPXXNFXAS
NP_top_reg:f:sD	NPXXNFXDS
NP_top_reg:f:sG	NPXXNFXGS
NP_top_reg:f:sI	NPXXNFXIS
NP_top_reg:f:sL	NPXXNFXLS
NP_top_reg:f:sN	NPXXNFXNS
	
NP_top_reg:m:sA	NPXXNMXAS
NP_top_reg:m:sD	NPXXNMXDS
NP_top_reg:m:sG	NPXXNMXGS
NP_top_reg:m:sI	NPXXNMXIS
NP_top_reg:m:sL	NPXXNMXLS
NP_top_reg:m:sN	NPXXNMXNS

NP_top_reg:n:sA	NPXXNNXAS
NP_top_reg:n:sD	NPXXNNXDS
NP_top_reg:n:sG	NPXXNNXGS
NP_top_reg:n:sI	NPXXNNXIS
NP_top_reg:n:sL	NPXXNNXLS
NP_top_reg:n:sN	NPXXNNXNS

NP_top_reg	NPXXNXXXX

NP_top_river:0:pA	NPXXNXXAP
NP_top_river:0:pD	NPXXNXXDP
NP_top_river:0:pG	NPXXNXXGP
NP_top_river:0:pI	NPXXNXXIP
NP_top_river:0:pL	NPXXNXXLP
NP_top_river:0:pN	NPXXNXXNP
	
NP_top_river:f:sA	NPXXNFXAS
NP_top_river:f:sD	NPXXNFXDS
NP_top_river:f:sG	NPXXNFXGS
NP_top_river:f:sI	NPXXNFXIS
NP_top_river:f:sL	NPXXNFXLS
NP_top_river:f:sN	NPXXNFXNS
	
NP_top_river:m:sA	NPXXNMXAS
NP_top_river:m:sD	NPXXNMXDS
NP_top_river:m:sG	NPXXNMXGS
NP_top_river:m:sI	NPXXNMXIS
NP_top_river:m:sL	NPXXNMXLS
NP_top_river:m:sN	NPXXNMXNS

NP_top_river:n:sA	NPXXNNXAS
NP_top_river:n:sD	NPXXNNXDS
NP_top_river:n:sG	NPXXNNXGS
NP_top_river:n:sI	NPXXNNXIS
NP_top_river:n:sL	NPXXNNXLS
NP_top_river:n:sN	NPXXNNXNS

NP_top_river	NPXXNXXXX

NP_top_stl:other:0:pA	NPXXNXXAP
NP_top_stl:other:0:pD	NPXXNXXDP
NP_top_stl:other:0:pG	NPXXNXXGP
NP_top_stl:other:0:pI	NPXXNXXIP
NP_top_stl:other:0:pL	NPXXNXXLP
NP_top_stl:other:0:pN	NPXXNXXNP
	
NP_top_stl:other:f:sA	NPXXNFXAS
NP_top_stl:other:f:sD	NPXXNFXDS
NP_top_stl:other:f:sG	NPXXNFXGS
NP_top_stl:other:f:sI	NPXXNFXIS
NP_top_stl:other:f:sL	NPXXNFXLS
NP_top_stl:other:f:sN	NPXXNFXNS
	
NP_top_stl:other:m:sA	NPXXNMXAS
NP_top_stl:other:m:sD	NPXXNMXDS
NP_top_stl:other:m:sG	NPXXNMXGS
NP_top_stl:other:m:sI	NPXXNMXIS
NP_top_stl:other:m:sL	NPXXNMXLS
NP_top_stl:other:m:sN	NPXXNMXNS

NP_top_stl:other:n:sA	NPXXNNXAS
NP_top_stl:other:n:sD	NPXXNNXDS
NP_top_stl:other:n:sG	NPXXNNXGS
NP_top_stl:other:n:sI	NPXXNNXIS
NP_top_stl:other:n:sL	NPXXNNXLS
NP_top_stl:other:n:sN	NPXXNNXNS

NP_top_stl:other	NPXXNXXXX

NP_top_stl:street:0:pA	NPXXNXXAP
NP_top_stl:street:0:pD	NPXXNXXDP
NP_top_stl:street:0:pG	NPXXNXXGP
NP_top_stl:street:0:pI	NPXXNXXIP
NP_top_stl:street:0:pL	NPXXNXXLP
NP_top_stl:street:0:pN	NPXXNXXNP
	
NP_top_stl:street:f:sA	NPXXNFXAS
NP_top_stl:street:f:sD	NPXXNFXDS
NP_top_stl:street:f:sG	NPXXNFXGS
NP_top_stl:street:f:sI	NPXXNFXIS
NP_top_stl:street:f:sL	NPXXNFXLS
NP_top_stl:street:f:sN	NPXXNFXNS
	
NP_top_stl:street:m:sA	NPXXNMXAS
NP_top_stl:street:m:sD	NPXXNMXDS
NP_top_stl:street:m:sG	NPXXNMXGS
NP_top_stl:street:m:sI	NPXXNMXIS
NP_top_stl:street:m:sL	NPXXNMXLS
NP_top_stl:street:m:sN	NPXXNMXNS

NP_top_stl:street:n:sA	NPXXNNXAS
NP_top_stl:street:n:sD	NPXXNNXDS
NP_top_stl:street:n:sG	NPXXNNXGS
NP_top_stl:street:n:sI	NPXXNNXIS
NP_top_stl:street:n:sL	NPXXNNXLS
NP_top_stl:street:n:sN	NPXXNNXNS

NP_top_stl:street	NPXXNXXXX

NP_top_stl:town:0:pA	NPXXNXXAP
NP_top_stl:town:0:pD	NPXXNXXDP
NP_top_stl:town:0:pG	NPXXNXXGP
NP_top_stl:town:0:pI	NPXXNXXIP
NP_top_stl:town:0:pL	NPXXNXXLP
NP_top_stl:town:0:pN	NPXXNXXNP
	
NP_top_stl:town:f:sA	NPXXNFXAS
NP_top_stl:town:f:sD	NPXXNFXDS
NP_top_stl:town:f:sG	NPXXNFXGS
NP_top_stl:town:f:sI	NPXXNFXIS
NP_top_stl:town:f:sL	NPXXNFXLS
NP_top_stl:town:f:sN	NPXXNFXNS
	
NP_top_stl:town:m:sA	NPXXNMXAS
NP_top_stl:town:m:sD	NPXXNMXDS
NP_top_stl:town:m:sG	NPXXNMXGS
NP_top_stl:town:m:sI	NPXXNMXIS
NP_top_stl:town:m:sL	NPXXNMXLS
NP_top_stl:town:m:sN	NPXXNMXNS

NP_top_stl:town:n:sA	NPXXNNXAS
NP_top_stl:town:n:sD	NPXXNNXDS
NP_top_stl:town:n:sG	NPXXNNXGS
NP_top_stl:town:n:sI	NPXXNNXIS
NP_top_stl:town:n:sL	NPXXNNXLS
NP_top_stl:town:n:sN	NPXXNNXNS

NP_top_stl:town	NPXXNXXXX

NP_org:0:pA	NPXXNXXAP
NP_org:0:pD	NPXXNXXDP
NP_org:0:pG	NPXXNXXGP
NP_org:0:pI	NPXXNXXIP
NP_org:0:pL	NPXXNXXLP
NP_org:0:pN	NPXXNXXNP
	
NP_org:f:sA	NPXXNFXAS
NP_org:f:sD	NPXXNFXDS
NP_org:f:sG	NPXXNFXGS
NP_org:f:sI	NPXXNFXIS
NP_org:f:sL	NPXXNFXLS
NP_org:f:sN	NPXXNFXNS

NP_org:m:sA	NPXXNMXAS
NP_org:m:sD	NPXXNMXDS
NP_org:m:sG	NPXXNMXGS
NP_org:m:sI	NPXXNMXIS
NP_org:m:sL	NPXXNMXLS
NP_org:m:sN	NPXXNMXNS

NP_org:n:sA	NPXXNNXAS
NP_org:n:sD	NPXXNNXDS
NP_org:n:sG	NPXXNNXGS
NP_org:n:sI	NPXXNNXIS
NP_org:n:sL	NPXXNNXLS
NP_org:n:sN	NPXXNNXNS

NP_org	NPXXNXXXX

N	NCXXNXXXX
	
N:Abbr	NCXXBXXXX
	
NP_abbr	NPXXBXXXX

# Глагол (неособые формы)

V:DD-:iap	VDDNXPXPX
V:DD-:iasf	VDDNXPXSF
V:DD-:iasm	VDDNXPXSM
V:DD-:iasn	VDDNXPXSN
V:DD-:Inf	VDDNX0XXX
V:DD-:ipp1	VDDNXR1PX|VDDNXF1PX
V:DD-:ipp2	VDDNXR2PX|VDDNXF2PX
V:DD-:ipp3	VDDNXR3PX|VDDNXF3PX
V:DD-:ips1	VDDNXR1SX|VDDNXF1SX
V:DD-:ips2	VDDNXR2SX|VDDNXF2SX
V:DD-:ips3	VDDNXR3SX|VDDNXF3SX
V:DD-:mp2	VDDNXI2PX
V:DD-:ms2	VDDNXI2SX
	
V:DI-:iap	VIDNXPXPX
V:DI-:iasf	VIDNXPXSF
V:DI-:iasm	VIDNXPXSM
V:DI-:iasn	VIDNXPXSN
V:DI-:Inf	VIDNX0XXX
V:DI-:ipp1	VIDNXR1PX|VIDNXF1PX
V:DI-:ipp2	VIDNXR2PX|VIDNXF2PX
V:DI-:ipp3	VIDNXR3PX|VIDNXF3PX
V:DI-:ips1	VIDNXR1SX|VIDNXF1SX
V:DI-:ips2	VIDNXR2SX|VIDNXF2SX
V:DI-:ips3	VIDNXR3SX|VIDNXF3SX
V:DI-:mp2	VIDNXI2PX
V:DI-:ms2	VIDNXI2SX
	
V:DI+:iap	VIDRXPXPX
V:DI+:iasf	VIDRXPXSF
V:DI+:iasm	VIDRXPXSM
V:DI+:iasn	VIDRXPXSN
V:DI+:Inf	VIDRX0XXX
V:DI+:ipp1	VIDRXR1PX|VIDRXF1PX
V:DI+:ipp2	VIDRXR2PX|VIDRXF2PX
V:DI+:ipp3	VIDRXR3PX|VIDRXF3PX
V:DI+:ips1	VIDRXR1SX|VIDRXF1SX
V:DI+:ips2	VIDRXR2SX|VIDRXF2SX
V:DI+:ips3	VIDRXR3SX|VIDRXF3SX
V:DI+:mp2	VIDRXI2PX
V:DI+:ms2	VIDRXI2SX
	
V:DT-:iap	VTDNXPXPX
V:DT-:iasf	VTDNXPXSF
V:DT-:iasm	VTDNXPXSM
V:DT-:iasn	VTDNXPXSN
V:DT-:Inf	VTDNX0XXX
V:DT-:ipp1	VTDNXR1PX|VTDNXF1PX
V:DT-:ipp2	VTDNXR2PX|VTDNXF2PX
V:DT-:ipp3	VTDNXR3PX|VTDNXF3PX
V:DT-:ips1	VTDNXR1SX|VTDNXF1SX
V:DT-:ips2	VTDNXR2SX|VTDNXF2SX
V:DT-:ips3	VTDNXR3SX|VTDNXF3SX
V:DT-:mp2	VTDNXI2PX
V:DT-:ms2	VTDNXI2SX
	
V:ID-:iap	VDMNXPXPX
V:ID-:iasf	VDMNXPXSF
V:ID-:iasm	VDMNXPXSM
V:ID-:iasn	VDMNXPXSN
V:ID-:Inf	VDMNX0XXX
V:ID-:ipp1	VDMNXR1PX
V:ID-:ipp2	VDMNXR2PX
V:ID-:ipp3	VDMNXR3PX
V:ID-:ips1	VDMNXR1SX
V:ID-:ips2	VDMNXR2SX
V:ID-:ips3	VDMNXR3SX
V:ID-:mp2	VDMNXI2PX
V:ID-:ms2	VDMNXI2SX
	
V:II-:iap	VIMNXPXPX
V:II-:iasf	VIMNXPXSF
V:II-:iasm	VIMNXPXSM
V:II-:iasn	VIMNXPXSN
V:II-:Inf	VIMNX0XXX
V:II-:ipp1	VIMNXR1PX
V:II-:ipp2	VIMNXR2PX
V:II-:ipp3	VIMNXR3PX
V:II-:ips1	VIMNXR1SX
V:II-:ips2	VIMNXR2SX
V:II-:ips3	VIMNXR3SX
V:II-:mp2	VIMNXI2PX
V:II-:ms2	VIMNXI2SX
	
V:II+:iap	VIMRXPXPX
V:II+:iasf	VIMRXPXSF
V:II+:iasm	VIMRXPXSM
V:II+:iasn	VIMRXPXSN
V:II+:Inf	VIMRX0XXX
V:II+:ipp1	VIMRXR1PX
V:II+:ipp2	VIMRXR2PX
V:II+:ipp3	VIMRXR3PX
V:II+:ips1	VIMRXR1SX
V:II+:ips2	VIMRXR2SX
V:II+:ips3	VIMRXR3SX
V:II+:mp2	VIMRXI2PX
V:II+:ms2	VIMRXI2SX
	
V:IT-:iap	VTMNXPXPX
V:IT-:iasf	VTMNXPXSF
V:IT-:iasm	VTMNXPXSM
V:IT-:iasn	VTMNXPXSN
V:IT-:Inf	VTMNX0XXX
V:IT-:ipp1	VTMNXR1PX
V:IT-:ipp2	VTMNXR2PX
V:IT-:ipp3	VTMNXR3PX
V:IT-:ips1	VTMNXR1SX
V:IT-:ips2	VTMNXR2SX
V:IT-:ips3	VTMNXR3SX
V:IT-:mp2	VTMNXI2PX
V:IT-:ms2	VTMNXI2SX
	
V:IT+:iap	VTMRXPXPX
V:IT+:iasf	VTMRXPXSF
V:IT+:iasm	VTMRXPXSM
V:IT+:iasn	VTMRXPXSN
V:IT+:Inf	VTMRX0XXX
V:IT+:ipp1	VTMRXR1PX
V:IT+:ipp2	VTMRXR2PX
V:IT+:ipp3	VTMRXR3PX
V:IT+:ips1	VTMRXR1SX
V:IT+:ips2	VTMRXR2SX
V:IT+:ips3	VTMRXR3SX
V:IT+:mp2	VTMRXI2PX
V:IT+:ms2	VTMRXI2SX
	
V:PD-:iap	VDPNXPXPX
V:PD-:iasf	VDPNXPXSF
V:PD-:iasm	VDPNXPXSM
V:PD-:iasn	VDPNXPXSN
V:PD-:Inf	VDPNX0XXX
V:PD-:ipp1	VDPNXF1PX
V:PD-:ipp2	VDPNXF2PX
V:PD-:ipp3	VDPNXF3PX
V:PD-:ips1	VDPNXF1SX
V:PD-:ips2	VDPNXF2SX
V:PD-:ips3	VDPNXF3SX
V:PD-:mp2	VDPNXI2PX
V:PD-:ms2	VDPNXI2SX
	
V:PI-:iap	VIPNXPXPX
V:PI-:iasf	VIPNXPXSF
V:PI-:iasm	VIPNXPXSM
V:PI-:iasn	VIPNXPXSN
V:PI-:Inf	VIPNX0XXX
V:PI-:ipp1	VIPNXF1PX
V:PI-:ipp2	VIPNXF2PX
V:PI-:ipp3	VIPNXF3PX
V:PI-:ips1	VIPNXF1SX
V:PI-:ips2	VIPNXF2SX
V:PI-:ips3	VIPNXF3SX
V:PI-:mp2	VIPNXI2PX
V:PI-:ms2	VIPNXI2SX
	
V:PI+:iap	VIPRXPXPX
V:PI+:iasf	VIPRXPXSF
V:PI+:iasm	VIPRXPXSM
V:PI+:iasn	VIPRXPXSN
V:PI+:Inf	VIPRX0XXX
V:PI+:ipp1	VIPRXF1PX
V:PI+:ipp2	VIPRXF2PX
V:PI+:ipp3	VIPRXF3PX
V:PI+:ips1	VIPRXF1SX
V:PI+:ips2	VIPRXF2SX
V:PI+:ips3	VIPRXF3SX
V:PI+:mp2	VIPRXI2PX
V:PI+:ms2	VIPRXI2SX
	
V:PT-:iap	VTPNXPXPX
V:PT-:iasf	VTPNXPXSF
V:PT-:iasm	VTPNXPXSM
V:PT-:iasn	VTPNXPXSN
V:PT-:Inf	VTPNX0XXX
V:PT-:ipp1	VTPNXF1PX
V:PT-:ipp2	VTPNXF2PX
V:PT-:ipp3	VTPNXF3PX
V:PT-:ips1	VTPNXF1SX
V:PT-:ips2	VTPNXF2SX
V:PT-:ips3	VTPNXF3SX
V:PT-:mp2	VTPNXI2PX
V:PT-:ms2	VTPNXI2SX
	
V:PT+:iap	VTPRXPXPX
V:PT+:iasf	VTPRXPXSF
V:PT+:iasm	VTPRXPXSM
V:PT+:iasn	VTPRXPXSN
V:PT+:Inf	VTPRX0XXX
V:PT+:ipp1	VTPRXF1PX
V:PT+:ipp2	VTPRXF2PX
V:PT+:ipp3	VTPRXF3PX
V:PT+:ips1	VTPRXF1SX
V:PT+:ips2	VTPRXF2SX
V:PT+:ips3	VTPRXF3SX
V:PT+:mp2	VTPRXI2PX
V:PT+:ms2	VTPRXI2SX

V:DD-1:iap	VDDN1PXPX
V:DD-1:iasf	VDDN1PXSF
V:DD-1:iasm	VDDN1PXSM
V:DD-1:iasn	VDDN1PXSN
V:DD-1:Inf	VDDN10XXX
V:DD-1:ipp1	VDDN1R1PX|VDDN1F1PX
V:DD-1:ipp2	VDDN1R2PX|VDDN1F2PX
V:DD-1:ipp3	VDDN1R3PX|VDDN1F3PX
V:DD-1:ips1	VDDN1R1SX|VDDN1F1SX
V:DD-1:ips2	VDDN1R2SX|VDDN1F2SX
V:DD-1:ips3	VDDN1R3SX|VDDN1F3SX
V:DD-1:mp2	VDDN1I2PX
V:DD-1:ms2	VDDN1I2SX
	
V:DI-1:iap	VIDN1PXPX
V:DI-1:iasf	VIDN1PXSF
V:DI-1:iasm	VIDN1PXSM
V:DI-1:iasn	VIDN1PXSN
V:DI-1:Inf	VIDN10XXX
V:DI-1:ipp1	VIDN1R1PX|VIDN1F1PX
V:DI-1:ipp2	VIDN1R2PX|VIDN1F2PX
V:DI-1:ipp3	VIDN1R3PX|VIDN1F3PX
V:DI-1:ips1	VIDN1R1SX|VIDN1F1SX
V:DI-1:ips2	VIDN1R2SX|VIDN1F2SX
V:DI-1:ips3	VIDN1R3SX|VIDN1F3SX
V:DI-1:mp2	VIDN1I2PX
V:DI-1:ms2	VIDN1I2SX
	
V:DI+1:iap	VIDR1PXPX
V:DI+1:iasf	VIDR1PXSF
V:DI+1:iasm	VIDR1PXSM
V:DI+1:iasn	VIDR1PXSN
V:DI+1:Inf	VIDR10XXX
V:DI+1:ipp1	VIDR1R1PX|VIDR1F1PX
V:DI+1:ipp2	VIDR1R2PX|VIDR1F2PX
V:DI+1:ipp3	VIDR1R3PX|VIDR1F3PX
V:DI+1:ips1	VIDR1R1SX|VIDR1F1SX
V:DI+1:ips2	VIDR1R2SX|VIDR1F2SX
V:DI+1:ips3	VIDR1R3SX|VIDR1F3SX
V:DI+1:mp2	VIDR1I2PX
V:DI+1:ms2	VIDR1I2SX
	
V:DT-1:iap	VTDN1PXPX
V:DT-1:iasf	VTDN1PXSF
V:DT-1:iasm	VTDN1PXSM
V:DT-1:iasn	VTDN1PXSN
V:DT-1:Inf	VTDN10XXX
V:DT-1:ipp1	VTDN1R1PX|VTDN1F1PX
V:DT-1:ipp2	VTDN1R2PX|VTDN1F2PX
V:DT-1:ipp3	VTDN1R3PX|VTDN1F3PX
V:DT-1:ips1	VTDN1R1SX|VTDN1F1SX
V:DT-1:ips2	VTDN1R2SX|VTDN1F2SX
V:DT-1:ips3	VTDN1R3SX|VTDN1F3SX
V:DT-1:mp2	VTDN1I2PX
V:DT-1:ms2	VTDN1I2SX
	
V:ID-1:iap	VDMN1PXPX
V:ID-1:iasf	VDMN1PXSF
V:ID-1:iasm	VDMN1PXSM
V:ID-1:iasn	VDMN1PXSN
V:ID-1:Inf	VDMN10XXX
V:ID-1:ipp1	VDMN1R1PX
V:ID-1:ipp2	VDMN1R2PX
V:ID-1:ipp3	VDMN1R3PX
V:ID-1:ips1	VDMN1R1SX
V:ID-1:ips2	VDMN1R2SX
V:ID-1:ips3	VDMN1R3SX
V:ID-1:mp2	VDMN1I2PX
V:ID-1:ms2	VDMN1I2SX
	
V:II-1:iap	VIMN1PXPX
V:II-1:iasf	VIMN1PXSF
V:II-1:iasm	VIMN1PXSM
V:II-1:iasn	VIMN1PXSN
V:II-1:Inf	VIMN10XXX
V:II-1:ipp1	VIMN1R1PX
V:II-1:ipp2	VIMN1R2PX
V:II-1:ipp3	VIMN1R3PX
V:II-1:ips1	VIMN1R1SX
V:II-1:ips2	VIMN1R2SX
V:II-1:ips3	VIMN1R3SX
V:II-1:mp2	VIMN1I2PX
V:II-1:ms2	VIMN1I2SX
	
V:II+1:iap	VIMR1PXPX
V:II+1:iasf	VIMR1PXSF
V:II+1:iasm	VIMR1PXSM
V:II+1:iasn	VIMR1PXSN
V:II+1:Inf	VIMR10XXX
V:II+1:ipp1	VIMR1R1PX
V:II+1:ipp2	VIMR1R2PX
V:II+1:ipp3	VIMR1R3PX
V:II+1:ips1	VIMR1R1SX
V:II+1:ips2	VIMR1R2SX
V:II+1:ips3	VIMR1R3SX
V:II+1:mp2	VIMR1I2PX
V:II+1:ms2	VIMR1I2SX
	
V:IT-1:iap	VTMN1PXPX
V:IT-1:iasf	VTMN1PXSF
V:IT-1:iasm	VTMN1PXSM
V:IT-1:iasn	VTMN1PXSN
V:IT-1:Inf	VTMN10XXX
V:IT-1:ipp1	VTMN1R1PX
V:IT-1:ipp2	VTMN1R2PX
V:IT-1:ipp3	VTMN1R3PX
V:IT-1:ips1	VTMN1R1SX
V:IT-1:ips2	VTMN1R2SX
V:IT-1:ips3	VTMN1R3SX
V:IT-1:mp2	VTMN1I2PX
V:IT-1:ms2	VTMN1I2SX
	
V:IT+1:iap	VTMR1PXPX
V:IT+1:iasf	VTMR1PXSF
V:IT+1:iasm	VTMR1PXSM
V:IT+1:iasn	VTMR1PXSN
V:IT+1:Inf	VTMR10XXX
V:IT+1:ipp1	VTMR1R1PX
V:IT+1:ipp2	VTMR1R2PX
V:IT+1:ipp3	VTMR1R3PX
V:IT+1:ips1	VTMR1R1SX
V:IT+1:ips2	VTMR1R2SX
V:IT+1:ips3	VTMR1R3SX
V:IT+1:mp2	VTMR1I2PX
V:IT+1:ms2	VTMR1I2SX
	
V:PD-1:iap	VDPN1PXPX
V:PD-1:iasf	VDPN1PXSF
V:PD-1:iasm	VDPN1PXSM
V:PD-1:iasn	VDPN1PXSN
V:PD-1:Inf	VDPN10XXX
V:PD-1:ipp1	VDPN1F1PX
V:PD-1:ipp2	VDPN1F2PX
V:PD-1:ipp3	VDPN1F3PX
V:PD-1:ips1	VDPN1F1SX
V:PD-1:ips2	VDPN1F2SX
V:PD-1:ips3	VDPN1F3SX
V:PD-1:mp2	VDPN1I2PX
V:PD-1:ms2	VDPN1I2SX
	
V:PI-1:iap	VIPN1PXPX
V:PI-1:iasf	VIPN1PXSF
V:PI-1:iasm	VIPN1PXSM
V:PI-1:iasn	VIPN1PXSN
V:PI-1:Inf	VIPN10XXX
V:PI-1:ipp1	VIPN1F1PX
V:PI-1:ipp2	VIPN1F2PX
V:PI-1:ipp3	VIPN1F3PX
V:PI-1:ips1	VIPN1F1SX
V:PI-1:ips2	VIPN1F2SX
V:PI-1:ips3	VIPN1F3SX
V:PI-1:mp2	VIPN1I2PX
V:PI-1:ms2	VIPN1I2SX
	
V:PI+1:iap	VIPR1PXPX
V:PI+1:iasf	VIPR1PXSF
V:PI+1:iasm	VIPR1PXSM
V:PI+1:iasn	VIPR1PXSN
V:PI+1:Inf	VIPR10XXX
V:PI+1:ipp1	VIPR1F1PX
V:PI+1:ipp2	VIPR1F2PX
V:PI+1:ipp3	VIPR1F3PX
V:PI+1:ips1	VIPR1F1SX
V:PI+1:ips2	VIPR1F2SX
V:PI+1:ips3	VIPR1F3SX
V:PI+1:mp2	VIPR1I2PX
V:PI+1:ms2	VIPR1I2SX
	
V:PT-1:iap	VTPN1PXPX
V:PT-1:iasf	VTPN1PXSF
V:PT-1:iasm	VTPN1PXSM
V:PT-1:iasn	VTPN1PXSN
V:PT-1:Inf	VTPN10XXX
V:PT-1:ipp1	VTPN1F1PX
V:PT-1:ipp2	VTPN1F2PX
V:PT-1:ipp3	VTPN1F3PX
V:PT-1:ips1	VTPN1F1SX
V:PT-1:ips2	VTPN1F2SX
V:PT-1:ips3	VTPN1F3SX
V:PT-1:mp2	VTPN1I2PX
V:PT-1:ms2	VTPN1I2SX
	
V:PT+1:iap	VTPR1PXPX
V:PT+1:iasf	VTPR1PXSF
V:PT+1:iasm	VTPR1PXSM
V:PT+1:iasn	VTPR1PXSN
V:PT+1:Inf	VTPR10XXX
V:PT+1:ipp1	VTPR1F1PX
V:PT+1:ipp2	VTPR1F2PX
V:PT+1:ipp3	VTPR1F3PX
V:PT+1:ips1	VTPR1F1SX
V:PT+1:ips2	VTPR1F2SX
V:PT+1:ips3	VTPR1F3SX
V:PT+1:mp2	VTPR1I2PX
V:PT+1:ms2	VTPR1I2SX

V:DD-2:iap	VDDN2PXPX
V:DD-2:iasf	VDDN2PXSF
V:DD-2:iasm	VDDN2PXSM
V:DD-2:iasn	VDDN2PXSN
V:DD-2:Inf	VDDN20XXX
V:DD-2:ipp1	VDDN2R1PX|VDDN2F1PX
V:DD-2:ipp2	VDDN2R2PX|VDDN2F2PX
V:DD-2:ipp3	VDDN2R3PX|VDDN2F3PX
V:DD-2:ips1	VDDN2R1SX|VDDN2F1SX
V:DD-2:ips2	VDDN2R2SX|VDDN2F2SX
V:DD-2:ips3	VDDN2R3SX|VDDN2F3SX
V:DD-2:mp2	VDDN2I2PX
V:DD-2:ms2	VDDN2I2SX
	
V:DI-2:iap	VIDN2PXPX
V:DI-2:iasf	VIDN2PXSF
V:DI-2:iasm	VIDN2PXSM
V:DI-2:iasn	VIDN2PXSN
V:DI-2:Inf	VIDN20XXX
V:DI-2:ipp1	VIDN2R1PX|VIDN2F1PX
V:DI-2:ipp2	VIDN2R2PX|VIDN2F2PX
V:DI-2:ipp3	VIDN2R3PX|VIDN2F3PX
V:DI-2:ips1	VIDN2R1SX|VIDN2F1SX
V:DI-2:ips2	VIDN2R2SX|VIDN2F2SX
V:DI-2:ips3	VIDN2R3SX|VIDN2F3SX
V:DI-2:mp2	VIDN2I2PX
V:DI-2:ms2	VIDN2I2SX
	
V:DI+2:iap	VIDR2PXPX
V:DI+2:iasf	VIDR2PXSF
V:DI+2:iasm	VIDR2PXSM
V:DI+2:iasn	VIDR2PXSN
V:DI+2:Inf	VIDR20XXX
V:DI+2:ipp1	VIDR2R1PX|VIDR2F1PX
V:DI+2:ipp2	VIDR2R2PX|VIDR2F2PX
V:DI+2:ipp3	VIDR2R3PX|VIDR2F3PX
V:DI+2:ips1	VIDR2R1SX|VIDR2F1SX
V:DI+2:ips2	VIDR2R2SX|VIDR2F2SX
V:DI+2:ips3	VIDR2R3SX|VIDR2F3SX
V:DI+2:mp2	VIDR2I2PX
V:DI+2:ms2	VIDR2I2SX
	
V:DT-2:iap	VTDN2PXPX
V:DT-2:iasf	VTDN2PXSF
V:DT-2:iasm	VTDN2PXSM
V:DT-2:iasn	VTDN2PXSN
V:DT-2:Inf	VTDN20XXX
V:DT-2:ipp1	VTDN2R1PX|VTDN2F1PX
V:DT-2:ipp2	VTDN2R2PX|VTDN2F2PX
V:DT-2:ipp3	VTDN2R3PX|VTDN2F3PX
V:DT-2:ips1	VTDN2R1SX|VTDN2F1SX
V:DT-2:ips2	VTDN2R2SX|VTDN2F2SX
V:DT-2:ips3	VTDN2R3SX|VTDN2F3SX
V:DT-2:mp2	VTDN2I2PX
V:DT-2:ms2	VTDN2I2SX
	
V:ID-2:iap	VDMN2PXPX
V:ID-2:iasf	VDMN2PXSF
V:ID-2:iasm	VDMN2PXSM
V:ID-2:iasn	VDMN2PXSN
V:ID-2:Inf	VDMN20XXX
V:ID-2:ipp1	VDMN2R1PX
V:ID-2:ipp2	VDMN2R2PX
V:ID-2:ipp3	VDMN2R3PX
V:ID-2:ips1	VDMN2R1SX
V:ID-2:ips2	VDMN2R2SX
V:ID-2:ips3	VDMN2R3SX
V:ID-2:mp2	VDMN2I2PX
V:ID-2:ms2	VDMN2I2SX
	
V:II-2:iap	VIMN2PXPX
V:II-2:iasf	VIMN2PXSF
V:II-2:iasm	VIMN2PXSM
V:II-2:iasn	VIMN2PXSN
V:II-2:Inf	VIMN20XXX
V:II-2:ipp1	VIMN2R1PX
V:II-2:ipp2	VIMN2R2PX
V:II-2:ipp3	VIMN2R3PX
V:II-2:ips1	VIMN2R1SX
V:II-2:ips2	VIMN2R2SX
V:II-2:ips3	VIMN2R3SX
V:II-2:mp2	VIMN2I2PX
V:II-2:ms2	VIMN2I2SX
	
V:II+2:iap	VIMR2PXPX
V:II+2:iasf	VIMR2PXSF
V:II+2:iasm	VIMR2PXSM
V:II+2:iasn	VIMR2PXSN
V:II+2:Inf	VIMR20XXX
V:II+2:ipp1	VIMR2R1PX
V:II+2:ipp2	VIMR2R2PX
V:II+2:ipp3	VIMR2R3PX
V:II+2:ips1	VIMR2R1SX
V:II+2:ips2	VIMR2R2SX
V:II+2:ips3	VIMR2R3SX
V:II+2:mp2	VIMR2I2PX
V:II+2:ms2	VIMR2I2SX
	
V:IT-2:iap	VTMN2PXPX
V:IT-2:iasf	VTMN2PXSF
V:IT-2:iasm	VTMN2PXSM
V:IT-2:iasn	VTMN2PXSN
V:IT-2:Inf	VTMN20XXX
V:IT-2:ipp1	VTMN2R1PX
V:IT-2:ipp2	VTMN2R2PX
V:IT-2:ipp3	VTMN2R3PX
V:IT-2:ips1	VTMN2R1SX
V:IT-2:ips2	VTMN2R2SX
V:IT-2:ips3	VTMN2R3SX
V:IT-2:mp2	VTMN2I2PX
V:IT-2:ms2	VTMN2I2SX
	
V:IT+2:iap	VTMR2PXPX
V:IT+2:iasf	VTMR2PXSF
V:IT+2:iasm	VTMR2PXSM
V:IT+2:iasn	VTMR2PXSN
V:IT+2:Inf	VTMR20XXX
V:IT+2:ipp1	VTMR2R1PX
V:IT+2:ipp2	VTMR2R2PX
V:IT+2:ipp3	VTMR2R3PX
V:IT+2:ips1	VTMR2R1SX
V:IT+2:ips2	VTMR2R2SX
V:IT+2:ips3	VTMR2R3SX
V:IT+2:mp2	VTMR2I2PX
V:IT+2:ms2	VTMR2I2SX
	
V:PD-2:iap	VDPN2PXPX
V:PD-2:iasf	VDPN2PXSF
V:PD-2:iasm	VDPN2PXSM
V:PD-2:iasn	VDPN2PXSN
V:PD-2:Inf	VDPN20XXX
V:PD-2:ipp1	VDPN2F1PX
V:PD-2:ipp2	VDPN2F2PX
V:PD-2:ipp3	VDPN2F3PX
V:PD-2:ips1	VDPN2F1SX
V:PD-2:ips2	VDPN2F2SX
V:PD-2:ips3	VDPN2F3SX
V:PD-2:mp2	VDPN2I2PX
V:PD-2:ms2	VDPN2I2SX
	
V:PI-2:iap	VIPN2PXPX
V:PI-2:iasf	VIPN2PXSF
V:PI-2:iasm	VIPN2PXSM
V:PI-2:iasn	VIPN2PXSN
V:PI-2:Inf	VIPN20XXX
V:PI-2:ipp1	VIPN2F1PX
V:PI-2:ipp2	VIPN2F2PX
V:PI-2:ipp3	VIPN2F3PX
V:PI-2:ips1	VIPN2F1SX
V:PI-2:ips2	VIPN2F2SX
V:PI-2:ips3	VIPN2F3SX
V:PI-2:mp2	VIPN2I2PX
V:PI-2:ms2	VIPN2I2SX
	
V:PI+2:iap	VIPR2PXPX
V:PI+2:iasf	VIPR2PXSF
V:PI+2:iasm	VIPR2PXSM
V:PI+2:iasn	VIPR2PXSN
V:PI+2:Inf	VIPR20XXX
V:PI+2:ipp1	VIPR2F1PX
V:PI+2:ipp2	VIPR2F2PX
V:PI+2:ipp3	VIPR2F3PX
V:PI+2:ips1	VIPR2F1SX
V:PI+2:ips2	VIPR2F2SX
V:PI+2:ips3	VIPR2F3SX
V:PI+2:mp2	VIPR2I2PX
V:PI+2:ms2	VIPR2I2SX
	
V:PT-2:iap	VTPN2PXPX
V:PT-2:iasf	VTPN2PXSF
V:PT-2:iasm	VTPN2PXSM
V:PT-2:iasn	VTPN2PXSN
V:PT-2:Inf	VTPN20XXX
V:PT-2:ipp1	VTPN2F1PX
V:PT-2:ipp2	VTPN2F2PX
V:PT-2:ipp3	VTPN2F3PX
V:PT-2:ips1	VTPN2F1SX
V:PT-2:ips2	VTPN2F2SX
V:PT-2:ips3	VTPN2F3SX
V:PT-2:mp2	VTPN2I2PX
V:PT-2:ms2	VTPN2I2SX
	
V:PT+2:iap	VTPR2PXPX
V:PT+2:iasf	VTPR2PXSF
V:PT+2:iasm	VTPR2PXSM
V:PT+2:iasn	VTPR2PXSN
V:PT+2:Inf	VTPR20XXX
V:PT+2:ipp1	VTPR2F1PX
V:PT+2:ipp2	VTPR2F2PX
V:PT+2:ipp3	VTPR2F3PX
V:PT+2:ips1	VTPR2F1SX
V:PT+2:ips2	VTPR2F2SX
V:PT+2:ips3	VTPR2F3SX
V:PT+2:mp2	VTPR2I2PX
V:PT+2:ms2	VTPR2I2SX

V:DD-3:iap	VDDN3PXPX
V:DD-3:iasf	VDDN3PXSF
V:DD-3:iasm	VDDN3PXSM
V:DD-3:iasn	VDDN3PXSN
V:DD-3:Inf	VDDN30XXX
V:DD-3:ipp1	VDDN3R1PX|VDDN3F1PX
V:DD-3:ipp2	VDDN3R2PX|VDDN3F2PX
V:DD-3:ipp3	VDDN3R3PX|VDDN3F3PX
V:DD-3:ips1	VDDN3R1SX|VDDN3F1SX
V:DD-3:ips2	VDDN3R2SX|VDDN3F2SX
V:DD-3:ips3	VDDN3R3SX|VDDN3F3SX
V:DD-3:mp2	VDDN3I2PX
V:DD-3:ms2	VDDN3I2SX
	
V:DI-3:iap	VIDN3PXPX
V:DI-3:iasf	VIDN3PXSF
V:DI-3:iasm	VIDN3PXSM
V:DI-3:iasn	VIDN3PXSN
V:DI-3:Inf	VIDN30XXX
V:DI-3:ipp1	VIDN3R1PX|VIDN3F1PX
V:DI-3:ipp2	VIDN3R2PX|VIDN3F2PX
V:DI-3:ipp3	VIDN3R3PX|VIDN3F3PX
V:DI-3:ips1	VIDN3R1SX|VIDN3F1SX
V:DI-3:ips2	VIDN3R2SX|VIDN3F2SX
V:DI-3:ips3	VIDN3R3SX|VIDN3F3SX
V:DI-3:mp2	VIDN3I2PX
V:DI-3:ms2	VIDN3I2SX
	
V:DI+3:iap	VIDR3PXPX
V:DI+3:iasf	VIDR3PXSF
V:DI+3:iasm	VIDR3PXSM
V:DI+3:iasn	VIDR3PXSN
V:DI+3:Inf	VIDR30XXX
V:DI+3:ipp1	VIDR3R1PX|VIDR3F1PX
V:DI+3:ipp2	VIDR3R2PX|VIDR3F2PX
V:DI+3:ipp3	VIDR3R3PX|VIDR3F3PX
V:DI+3:ips1	VIDR3R1SX|VIDR3F1SX
V:DI+3:ips2	VIDR3R2SX|VIDR3F2SX
V:DI+3:ips3	VIDR3R3SX|VIDR3F3SX
V:DI+3:mp2	VIDR3I2PX
V:DI+3:ms2	VIDR3I2SX
	
V:DT-3:iap	VTDN3PXPX
V:DT-3:iasf	VTDN3PXSF
V:DT-3:iasm	VTDN3PXSM
V:DT-3:iasn	VTDN3PXSN
V:DT-3:Inf	VTDN30XXX
V:DT-3:ipp1	VTDN3R1PX|VTDN3F1PX
V:DT-3:ipp2	VTDN3R2PX|VTDN3F2PX
V:DT-3:ipp3	VTDN3R3PX|VTDN3F3PX
V:DT-3:ips1	VTDN3R1SX|VTDN3F1SX
V:DT-3:ips2	VTDN3R2SX|VTDN3F2SX
V:DT-3:ips3	VTDN3R3SX|VTDN3F3SX
V:DT-3:mp2	VTDN3I2PX
V:DT-3:ms2	VTDN3I2SX
	
V:ID-3:iap	VDMN3PXPX
V:ID-3:iasf	VDMN3PXSF
V:ID-3:iasm	VDMN3PXSM
V:ID-3:iasn	VDMN3PXSN
V:ID-3:Inf	VDMN30XXX
V:ID-3:ipp1	VDMN3R1PX
V:ID-3:ipp2	VDMN3R2PX
V:ID-3:ipp3	VDMN3R3PX
V:ID-3:ips1	VDMN3R1SX
V:ID-3:ips2	VDMN3R2SX
V:ID-3:ips3	VDMN3R3SX
V:ID-3:mp2	VDMN3I2PX
V:ID-3:ms2	VDMN3I2SX
	
V:II-3:iap	VIMN3PXPX
V:II-3:iasf	VIMN3PXSF
V:II-3:iasm	VIMN3PXSM
V:II-3:iasn	VIMN3PXSN
V:II-3:Inf	VIMN30XXX
V:II-3:ipp1	VIMN3R1PX
V:II-3:ipp2	VIMN3R2PX
V:II-3:ipp3	VIMN3R3PX
V:II-3:ips1	VIMN3R1SX
V:II-3:ips2	VIMN3R2SX
V:II-3:ips3	VIMN3R3SX
V:II-3:mp2	VIMN3I2PX
V:II-3:ms2	VIMN3I2SX
	
V:II+3:iap	VIMR3PXPX
V:II+3:iasf	VIMR3PXSF
V:II+3:iasm	VIMR3PXSM
V:II+3:iasn	VIMR3PXSN
V:II+3:Inf	VIMR30XXX
V:II+3:ipp1	VIMR3R1PX
V:II+3:ipp2	VIMR3R2PX
V:II+3:ipp3	VIMR3R3PX
V:II+3:ips1	VIMR3R1SX
V:II+3:ips2	VIMR3R2SX
V:II+3:ips3	VIMR3R3SX
V:II+3:mp2	VIMR3I2PX
V:II+3:ms2	VIMR3I2SX
	
V:IT-3:iap	VTMN3PXPX
V:IT-3:iasf	VTMN3PXSF
V:IT-3:iasm	VTMN3PXSM
V:IT-3:iasn	VTMN3PXSN
V:IT-3:Inf	VTMN30XXX
V:IT-3:ipp1	VTMN3R1PX
V:IT-3:ipp2	VTMN3R2PX
V:IT-3:ipp3	VTMN3R3PX
V:IT-3:ips1	VTMN3R1SX
V:IT-3:ips2	VTMN3R2SX
V:IT-3:ips3	VTMN3R3SX
V:IT-3:mp2	VTMN3I2PX
V:IT-3:ms2	VTMN3I2SX
	
V:IT+3:iap	VTMR3PXPX
V:IT+3:iasf	VTMR3PXSF
V:IT+3:iasm	VTMR3PXSM
V:IT+3:iasn	VTMR3PXSN
V:IT+3:Inf	VTMR30XXX
V:IT+3:ipp1	VTMR3R1PX
V:IT+3:ipp2	VTMR3R2PX
V:IT+3:ipp3	VTMR3R3PX
V:IT+3:ips1	VTMR3R1SX
V:IT+3:ips2	VTMR3R2SX
V:IT+3:ips3	VTMR3R3SX
V:IT+3:mp2	VTMR3I2PX
V:IT+3:ms2	VTMR3I2SX
	
V:PD-3:iap	VDPN3PXPX
V:PD-3:iasf	VDPN3PXSF
V:PD-3:iasm	VDPN3PXSM
V:PD-3:iasn	VDPN3PXSN
V:PD-3:Inf	VDPN30XXX
V:PD-3:ipp1	VDPN3F1PX
V:PD-3:ipp2	VDPN3F2PX
V:PD-3:ipp3	VDPN3F3PX
V:PD-3:ips1	VDPN3F1SX
V:PD-3:ips2	VDPN3F2SX
V:PD-3:ips3	VDPN3F3SX
V:PD-3:mp2	VDPN3I2PX
V:PD-3:ms2	VDPN3I2SX
	
V:PI-3:iap	VIPN3PXPX
V:PI-3:iasf	VIPN3PXSF
V:PI-3:iasm	VIPN3PXSM
V:PI-3:iasn	VIPN3PXSN
V:PI-3:Inf	VIPN30XXX
V:PI-3:ipp1	VIPN3F1PX
V:PI-3:ipp2	VIPN3F2PX
V:PI-3:ipp3	VIPN3F3PX
V:PI-3:ips1	VIPN3F1SX
V:PI-3:ips2	VIPN3F2SX
V:PI-3:ips3	VIPN3F3SX
V:PI-3:mp2	VIPN3I2PX
V:PI-3:ms2	VIPN3I2SX
	
V:PI+3:iap	VIPR3PXPX
V:PI+3:iasf	VIPR3PXSF
V:PI+3:iasm	VIPR3PXSM
V:PI+3:iasn	VIPR3PXSN
V:PI+3:Inf	VIPR30XXX
V:PI+3:ipp1	VIPR3F1PX
V:PI+3:ipp2	VIPR3F2PX
V:PI+3:ipp3	VIPR3F3PX
V:PI+3:ips1	VIPR3F1SX
V:PI+3:ips2	VIPR3F2SX
V:PI+3:ips3	VIPR3F3SX
V:PI+3:mp2	VIPR3I2PX
V:PI+3:ms2	VIPR3I2SX
	
V:PT-3:iap	VTPN3PXPX
V:PT-3:iasf	VTPN3PXSF
V:PT-3:iasm	VTPN3PXSM
V:PT-3:iasn	VTPN3PXSN
V:PT-3:Inf	VTPN30XXX
V:PT-3:ipp1	VTPN3F1PX
V:PT-3:ipp2	VTPN3F2PX
V:PT-3:ipp3	VTPN3F3PX
V:PT-3:ips1	VTPN3F1SX
V:PT-3:ips2	VTPN3F2SX
V:PT-3:ips3	VTPN3F3SX
V:PT-3:mp2	VTPN3I2PX
V:PT-3:ms2	VTPN3I2SX
	
V:PT+3:iap	VTPR3PXPX
V:PT+3:iasf	VTPR3PXSF
V:PT+3:iasm	VTPR3PXSM
V:PT+3:iasn	VTPR3PXSN
V:PT+3:Inf	VTPR30XXX
V:PT+3:ipp1	VTPR3F1PX
V:PT+3:ipp2	VTPR3F2PX
V:PT+3:ipp3	VTPR3F3PX
V:PT+3:ips1	VTPR3F1SX
V:PT+3:ips2	VTPR3F2SX
V:PT+3:ips3	VTPR3F3SX
V:PT+3:mp2	VTPR3I2PX
V:PT+3:ms2	VTPR3I2SX

# Деепричастие

V:Adv:DD-	DDDNX
V:Adv:DI-	DIDNX
V:Adv:DI+	DIDRX
V:Adv:DT-	DTDNX
V:Adv:ID-	DDMNX
V:Adv:II-	DIMNX
V:Adv:II+	DIMRX
V:Adv:IT-	DTMNX
V:Adv:IT+	DTMRX
V:Adv:PD-	DDPNX
V:Adv:PI-	DIPNX
V:Adv:PI+	DIPRX
V:Adv:PT-	DTPNX
V:Adv:PT+	DTPRX

V:Adv:DD-1	DDDN1
V:Adv:DI-1	DIDN1
V:Adv:DI+1	DIDR1
V:Adv:DT-1	DTDN1
V:Adv:ID-1	DDMN1
V:Adv:II-1	DIMN1
V:Adv:II+1	DIMR1
V:Adv:IT-1	DTMN1
V:Adv:IT+1	DTMR1
V:Adv:PD-1	DDPN1
V:Adv:PI-1	DIPN1
V:Adv:PI+1	DIPR1
V:Adv:PT-1	DTPN1
V:Adv:PT+1	DTPR1

V:Adv:DD-2	DDDN2
V:Adv:DI-2	DIDN2
V:Adv:DI+2	DIDR2
V:Adv:DT-2	DTDN2
V:Adv:ID-2	DDMN2
V:Adv:II-2	DIMN2
V:Adv:II+2	DIMR2
V:Adv:IT-2	DTMN2
V:Adv:IT+2	DTMR2
V:Adv:PD-2	DDPN2
V:Adv:PI-2	DIPN2
V:Adv:PI+2	DIPR2
V:Adv:PT-2	DTPN2
V:Adv:PT+2	DTPR2

V:Adv:DD-3	DDDN3
V:Adv:DI-3	DIDN3
V:Adv:DI+3	DIDR3
V:Adv:DT-3	DTDN3
V:Adv:ID-3	DDMN3
V:Adv:II-3	DIMN3
V:Adv:II+3	DIMR3
V:Adv:IT-3	DTMN3
V:Adv:IT+3	DTMR3
V:Adv:PD-3	DDPN3
V:Adv:PI-3	DIPN3
V:Adv:PI+3	DIPR3
V:Adv:PT-3	DTPN3
V:Adv:PT+3	DTPR3

# Причастие

V:Part:DD-:act:0pA	PAXDXAPF
V:Part:DD-:act:0pD	PAXDXDPF
V:Part:DD-:act:0pG	PAXDXGPF
V:Part:DD-:act:0pI	PAXDXIPF
V:Part:DD-:act:0pL	PAXDXLPF
V:Part:DD-:act:0pN	PAXDXNPF
V:Part:DD-:act:fsA	PAXDFASF
V:Part:DD-:act:fsD	PAXDFDSF
V:Part:DD-:act:fsG	PAXDFGSF
V:Part:DD-:act:fsI	PAXDFISF
V:Part:DD-:act:fsL	PAXDFLSF
V:Part:DD-:act:fsN	PAXDFNSF
V:Part:DD-:act:msA	PAXDMASF
V:Part:DD-:act:msD	PAXDMDSF
V:Part:DD-:act:msG	PAXDMGSF
V:Part:DD-:act:msI	PAXDMISF
V:Part:DD-:act:msL	PAXDMLSF
V:Part:DD-:act:msN	PAXDMNSF
V:Part:DD-:act:nsA	PAXDNASF
V:Part:DD-:act:nsD	PAXDNDSF
V:Part:DD-:act:nsG	PAXDNGSF
V:Part:DD-:act:nsI	PAXDNISF
V:Part:DD-:act:nsL	PAXDNLSF
V:Part:DD-:act:nsN	PAXDNNSF
	
V:Part:DI-:act:0pA	PAXDXAPF
V:Part:DI-:act:0pD	PAXDXDPF
V:Part:DI-:act:0pG	PAXDXGPF
V:Part:DI-:act:0pI	PAXDXIPF
V:Part:DI-:act:0pL	PAXDXLPF
V:Part:DI-:act:0pN	PAXDXNPF
V:Part:DI-:act:fsA	PAXDFASF
V:Part:DI-:act:fsD	PAXDFDSF
V:Part:DI-:act:fsG	PAXDFGSF
V:Part:DI-:act:fsI	PAXDFISF
V:Part:DI-:act:fsL	PAXDFLSF
V:Part:DI-:act:fsN	PAXDFNSF
V:Part:DI-:act:msA	PAXDMASF
V:Part:DI-:act:msD	PAXDMDSF
V:Part:DI-:act:msG	PAXDMGSF
V:Part:DI-:act:msI	PAXDMISF
V:Part:DI-:act:msL	PAXDMLSF
V:Part:DI-:act:msN	PAXDMNSF
V:Part:DI-:act:nsA	PAXDNASF
V:Part:DI-:act:nsD	PAXDNDSF
V:Part:DI-:act:nsG	PAXDNGSF
V:Part:DI-:act:nsI	PAXDNISF
V:Part:DI-:act:nsL	PAXDNLSF
V:Part:DI-:act:nsN	PAXDNNSF
	
V:Part:DI+:act:0pA	PAXDXAPF
V:Part:DI+:act:0pD	PAXDXDPF
V:Part:DI+:act:0pG	PAXDXGPF
V:Part:DI+:act:0pI	PAXDXIPF
V:Part:DI+:act:0pL	PAXDXLPF
V:Part:DI+:act:0pN	PAXDXNPF
V:Part:DI+:act:fsA	PAXDFASF
V:Part:DI+:act:fsD	PAXDFDSF
V:Part:DI+:act:fsG	PAXDFGSF
V:Part:DI+:act:fsI	PAXDFISF
V:Part:DI+:act:fsL	PAXDFLSF
V:Part:DI+:act:fsN	PAXDFNSF
V:Part:DI+:act:msA	PAXDMASF
V:Part:DI+:act:msD	PAXDMDSF
V:Part:DI+:act:msG	PAXDMGSF
V:Part:DI+:act:msI	PAXDMISF
V:Part:DI+:act:msL	PAXDMLSF
V:Part:DI+:act:msN	PAXDMNSF
V:Part:DI+:act:nsA	PAXDNASF
V:Part:DI+:act:nsD	PAXDNDSF
V:Part:DI+:act:nsG	PAXDNGSF
V:Part:DI+:act:nsI	PAXDNISF
V:Part:DI+:act:nsL	PAXDNLSF
V:Part:DI+:act:nsN	PAXDNNSF
	
V:Part:DT-:act:0pA	PAXDXAPF
V:Part:DT-:act:0pD	PAXDXDPF
V:Part:DT-:act:0pG	PAXDXGPF
V:Part:DT-:act:0pI	PAXDXIPF
V:Part:DT-:act:0pL	PAXDXLPF
V:Part:DT-:act:0pN	PAXDXNPF
V:Part:DT-:act:fsA	PAXDFASF
V:Part:DT-:act:fsD	PAXDFDSF
V:Part:DT-:act:fsG	PAXDFGSF
V:Part:DT-:act:fsI	PAXDFISF
V:Part:DT-:act:fsL	PAXDFLSF
V:Part:DT-:act:fsN	PAXDFNSF
V:Part:DT-:act:msA	PAXDMASF
V:Part:DT-:act:msD	PAXDMDSF
V:Part:DT-:act:msG	PAXDMGSF
V:Part:DT-:act:msI	PAXDMISF
V:Part:DT-:act:msL	PAXDMLSF
V:Part:DT-:act:msN	PAXDMNSF
V:Part:DT-:act:nsA	PAXDNASF
V:Part:DT-:act:nsD	PAXDNDSF
V:Part:DT-:act:nsG	PAXDNGSF
V:Part:DT-:act:nsI	PAXDNISF
V:Part:DT-:act:nsL	PAXDNLSF
V:Part:DT-:act:nsN	PAXDNNSF
	
V:Part:ID-:act:0pA	PAXIXAPF
V:Part:ID-:act:0pD	PAXIXDPF
V:Part:ID-:act:0pG	PAXIXGPF
V:Part:ID-:act:0pI	PAXIXIPF
V:Part:ID-:act:0pL	PAXIXLPF
V:Part:ID-:act:0pN	PAXIXNPF
V:Part:ID-:act:fsA	PAXIFASF
V:Part:ID-:act:fsD	PAXIFDSF
V:Part:ID-:act:fsG	PAXIFGSF
V:Part:ID-:act:fsI	PAXIFISF
V:Part:ID-:act:fsL	PAXIFLSF
V:Part:ID-:act:fsN	PAXIFNSF
V:Part:ID-:act:msA	PAXIMASF
V:Part:ID-:act:msD	PAXIMDSF
V:Part:ID-:act:msG	PAXIMGSF
V:Part:ID-:act:msI	PAXIMISF
V:Part:ID-:act:msL	PAXIMLSF
V:Part:ID-:act:msN	PAXIMNSF
V:Part:ID-:act:nsA	PAXINASF
V:Part:ID-:act:nsD	PAXINDSF
V:Part:ID-:act:nsG	PAXINGSF
V:Part:ID-:act:nsI	PAXINISF
V:Part:ID-:act:nsL	PAXINLSF
V:Part:ID-:act:nsN	PAXINNSF
	
V:Part:II-:act:0pA	PAXIXAPF
V:Part:II-:act:0pD	PAXIXDPF
V:Part:II-:act:0pG	PAXIXGPF
V:Part:II-:act:0pI	PAXIXIPF
V:Part:II-:act:0pL	PAXIXLPF
V:Part:II-:act:0pN	PAXIXNPF
V:Part:II-:act:fsA	PAXIFASF
V:Part:II-:act:fsD	PAXIFDSF
V:Part:II-:act:fsG	PAXIFGSF
V:Part:II-:act:fsI	PAXIFISF
V:Part:II-:act:fsL	PAXIFLSF
V:Part:II-:act:fsN	PAXIFNSF
V:Part:II-:act:msA	PAXIMASF
V:Part:II-:act:msD	PAXIMDSF
V:Part:II-:act:msG	PAXIMGSF
V:Part:II-:act:msI	PAXIMISF
V:Part:II-:act:msL	PAXIMLSF
V:Part:II-:act:msN	PAXIMNSF
V:Part:II-:act:nsA	PAXINASF
V:Part:II-:act:nsD	PAXINDSF
V:Part:II-:act:nsG	PAXINGSF
V:Part:II-:act:nsI	PAXINISF
V:Part:II-:act:nsL	PAXINLSF
V:Part:II-:act:nsN	PAXINNSF
	
V:Part:II+:act:0pA	PAXIXAPF
V:Part:II+:act:0pD	PAXIXDPF
V:Part:II+:act:0pG	PAXIXGPF
V:Part:II+:act:0pI	PAXIXIPF
V:Part:II+:act:0pL	PAXIXLPF
V:Part:II+:act:0pN	PAXIXNPF
V:Part:II+:act:fsA	PAXIFASF
V:Part:II+:act:fsD	PAXIFDSF
V:Part:II+:act:fsG	PAXIFGSF
V:Part:II+:act:fsI	PAXIFISF
V:Part:II+:act:fsL	PAXIFLSF
V:Part:II+:act:fsN	PAXIFNSF
V:Part:II+:act:msA	PAXIMASF
V:Part:II+:act:msD	PAXIMDSF
V:Part:II+:act:msG	PAXIMGSF
V:Part:II+:act:msI	PAXIMISF
V:Part:II+:act:msL	PAXIMLSF
V:Part:II+:act:msN	PAXIMNSF
V:Part:II+:act:nsA	PAXINASF
V:Part:II+:act:nsD	PAXINDSF
V:Part:II+:act:nsG	PAXINGSF
V:Part:II+:act:nsI	PAXINISF
V:Part:II+:act:nsL	PAXINLSF
V:Part:II+:act:nsN	PAXINNSF
	
V:Part:IT-:act:0pA	PAXIXAPF
V:Part:IT-:act:0pD	PAXIXDPF
V:Part:IT-:act:0pG	PAXIXGPF
V:Part:IT-:act:0pI	PAXIXIPF
V:Part:IT-:act:0pL	PAXIXLPF
V:Part:IT-:act:0pN	PAXIXNPF
V:Part:IT-:act:fsA	PAXIFASF
V:Part:IT-:act:fsD	PAXIFDSF
V:Part:IT-:act:fsG	PAXIFGSF
V:Part:IT-:act:fsI	PAXIFISF
V:Part:IT-:act:fsL	PAXIFLSF
V:Part:IT-:act:fsN	PAXIFNSF
V:Part:IT-:act:msA	PAXIMASF
V:Part:IT-:act:msD	PAXIMDSF
V:Part:IT-:act:msG	PAXIMGSF
V:Part:IT-:act:msI	PAXIMISF
V:Part:IT-:act:msL	PAXIMLSF
V:Part:IT-:act:msN	PAXIMNSF
V:Part:IT-:act:nsA	PAXINASF
V:Part:IT-:act:nsD	PAXINDSF
V:Part:IT-:act:nsG	PAXINGSF
V:Part:IT-:act:nsI	PAXINISF
V:Part:IT-:act:nsL	PAXINLSF
V:Part:IT-:act:nsN	PAXINNSF
	
V:Part:IT+:act:0pA	PAXIXAPF
V:Part:IT+:act:0pD	PAXIXDPF
V:Part:IT+:act:0pG	PAXIXGPF
V:Part:IT+:act:0pI	PAXIXIPF
V:Part:IT+:act:0pL	PAXIXLPF
V:Part:IT+:act:0pN	PAXIXNPF
V:Part:IT+:act:fsA	PAXIFASF
V:Part:IT+:act:fsD	PAXIFDSF
V:Part:IT+:act:fsG	PAXIFGSF
V:Part:IT+:act:fsI	PAXIFISF
V:Part:IT+:act:fsL	PAXIFLSF
V:Part:IT+:act:fsN	PAXIFNSF
V:Part:IT+:act:msA	PAXIMASF
V:Part:IT+:act:msD	PAXIMDSF
V:Part:IT+:act:msG	PAXIMGSF
V:Part:IT+:act:msI	PAXIMISF
V:Part:IT+:act:msL	PAXIMLSF
V:Part:IT+:act:msN	PAXIMNSF
V:Part:IT+:act:nsA	PAXINASF
V:Part:IT+:act:nsD	PAXINDSF
V:Part:IT+:act:nsG	PAXINGSF
V:Part:IT+:act:nsI	PAXINISF
V:Part:IT+:act:nsL	PAXINLSF
V:Part:IT+:act:nsN	PAXINNSF
	
V:Part:PD-:act:0pA	PAXPXAPF
V:Part:PD-:act:0pD	PAXPXDPF
V:Part:PD-:act:0pG	PAXPXGPF
V:Part:PD-:act:0pI	PAXPXIPF
V:Part:PD-:act:0pL	PAXPXLPF
V:Part:PD-:act:0pN	PAXPXNPF
V:Part:PD-:act:fsA	PAXPFASF
V:Part:PD-:act:fsD	PAXPFDSF
V:Part:PD-:act:fsG	PAXPFGSF
V:Part:PD-:act:fsI	PAXPFISF
V:Part:PD-:act:fsL	PAXPFLSF
V:Part:PD-:act:fsN	PAXPFNSF
V:Part:PD-:act:msA	PAXPMASF
V:Part:PD-:act:msD	PAXPMDSF
V:Part:PD-:act:msG	PAXPMGSF
V:Part:PD-:act:msI	PAXPMISF
V:Part:PD-:act:msL	PAXPMLSF
V:Part:PD-:act:msN	PAXPMNSF
V:Part:PD-:act:nsA	PAXPNASF
V:Part:PD-:act:nsD	PAXPNDSF
V:Part:PD-:act:nsG	PAXPNGSF
V:Part:PD-:act:nsI	PAXPNISF
V:Part:PD-:act:nsL	PAXPNLSF
V:Part:PD-:act:nsN	PAXPNNSF
	
V:Part:PI-:act:0pA	PAXPXAPF
V:Part:PI-:act:0pD	PAXPXDPF
V:Part:PI-:act:0pG	PAXPXGPF
V:Part:PI-:act:0pI	PAXPXIPF
V:Part:PI-:act:0pL	PAXPXLPF
V:Part:PI-:act:0pN	PAXPXNPF
V:Part:PI-:act:fsA	PAXPFASF
V:Part:PI-:act:fsD	PAXPFDSF
V:Part:PI-:act:fsG	PAXPFGSF
V:Part:PI-:act:fsI	PAXPFISF
V:Part:PI-:act:fsL	PAXPFLSF
V:Part:PI-:act:fsN	PAXPFNSF
V:Part:PI-:act:msA	PAXPMASF
V:Part:PI-:act:msD	PAXPMDSF
V:Part:PI-:act:msG	PAXPMGSF
V:Part:PI-:act:msI	PAXPMISF
V:Part:PI-:act:msL	PAXPMLSF
V:Part:PI-:act:msN	PAXPMNSF
V:Part:PI-:act:nsA	PAXPNASF
V:Part:PI-:act:nsD	PAXPNDSF
V:Part:PI-:act:nsG	PAXPNGSF
V:Part:PI-:act:nsI	PAXPNISF
V:Part:PI-:act:nsL	PAXPNLSF
V:Part:PI-:act:nsN	PAXPNNSF
	
V:Part:PI+:act:0pA	PAXPXAPF
V:Part:PI+:act:0pD	PAXPXDPF
V:Part:PI+:act:0pG	PAXPXGPF
V:Part:PI+:act:0pI	PAXPXIPF
V:Part:PI+:act:0pL	PAXPXLPF
V:Part:PI+:act:0pN	PAXPXNPF
V:Part:PI+:act:fsA	PAXPFASF
V:Part:PI+:act:fsD	PAXPFDSF
V:Part:PI+:act:fsG	PAXPFGSF
V:Part:PI+:act:fsI	PAXPFISF
V:Part:PI+:act:fsL	PAXPFLSF
V:Part:PI+:act:fsN	PAXPFNSF
V:Part:PI+:act:msA	PAXPMASF
V:Part:PI+:act:msD	PAXPMDSF
V:Part:PI+:act:msG	PAXPMGSF
V:Part:PI+:act:msI	PAXPMISF
V:Part:PI+:act:msL	PAXPMLSF
V:Part:PI+:act:msN	PAXPMNSF
V:Part:PI+:act:nsA	PAXPNASF
V:Part:PI+:act:nsD	PAXPNDSF
V:Part:PI+:act:nsG	PAXPNGSF
V:Part:PI+:act:nsI	PAXPNISF
V:Part:PI+:act:nsL	PAXPNLSF
V:Part:PI+:act:nsN	PAXPNNSF
	
V:Part:PT-:act:0pA	PAXPXAPF
V:Part:PT-:act:0pD	PAXPXDPF
V:Part:PT-:act:0pG	PAXPXGPF
V:Part:PT-:act:0pI	PAXPXIPF
V:Part:PT-:act:0pL	PAXPXLPF
V:Part:PT-:act:0pN	PAXPXNPF
V:Part:PT-:act:fsA	PAXPFASF
V:Part:PT-:act:fsD	PAXPFDSF
V:Part:PT-:act:fsG	PAXPFGSF
V:Part:PT-:act:fsI	PAXPFISF
V:Part:PT-:act:fsL	PAXPFLSF
V:Part:PT-:act:fsN	PAXPFNSF
V:Part:PT-:act:msA	PAXPMASF
V:Part:PT-:act:msD	PAXPMDSF
V:Part:PT-:act:msG	PAXPMGSF
V:Part:PT-:act:msI	PAXPMISF
V:Part:PT-:act:msL	PAXPMLSF
V:Part:PT-:act:msN	PAXPMNSF
V:Part:PT-:act:nsA	PAXPNASF
V:Part:PT-:act:nsD	PAXPNDSF
V:Part:PT-:act:nsG	PAXPNGSF
V:Part:PT-:act:nsI	PAXPNISF
V:Part:PT-:act:nsL	PAXPNLSF
V:Part:PT-:act:nsN	PAXPNNSF
	
V:Part:PT+:act:0pA	PAXPXAPF
V:Part:PT+:act:0pD	PAXPXDPF
V:Part:PT+:act:0pG	PAXPXGPF
V:Part:PT+:act:0pI	PAXPXIPF
V:Part:PT+:act:0pL	PAXPXLPF
V:Part:PT+:act:0pN	PAXPXNPF
V:Part:PT+:act:fsA	PAXPFASF
V:Part:PT+:act:fsD	PAXPFDSF
V:Part:PT+:act:fsG	PAXPFGSF
V:Part:PT+:act:fsI	PAXPFISF
V:Part:PT+:act:fsL	PAXPFLSF
V:Part:PT+:act:fsN	PAXPFNSF
V:Part:PT+:act:msA	PAXPMASF
V:Part:PT+:act:msD	PAXPMDSF
V:Part:PT+:act:msG	PAXPMGSF
V:Part:PT+:act:msI	PAXPMISF
V:Part:PT+:act:msL	PAXPMLSF
V:Part:PT+:act:msN	PAXPMNSF
V:Part:PT+:act:nsA	PAXPNASF
V:Part:PT+:act:nsD	PAXPNDSF
V:Part:PT+:act:nsG	PAXPNGSF
V:Part:PT+:act:nsI	PAXPNISF
V:Part:PT+:act:nsL	PAXPNLSF
V:Part:PT+:act:nsN	PAXPNNSF

V:Part:DD-:act:p:0pA	PARDXAPF
V:Part:DD-:act:p:0pD	PARDXDPF
V:Part:DD-:act:p:0pG	PARDXGPF
V:Part:DD-:act:p:0pI	PARDXIPF
V:Part:DD-:act:p:0pL	PARDXLPF
V:Part:DD-:act:p:0pN	PARDXNPF
V:Part:DD-:act:p:fsA	PARDFASF
V:Part:DD-:act:p:fsD	PARDFDSF
V:Part:DD-:act:p:fsG	PARDFGSF
V:Part:DD-:act:p:fsI	PARDFISF
V:Part:DD-:act:p:fsL	PARDFLSF
V:Part:DD-:act:p:fsN	PARDFNSF
V:Part:DD-:act:p:msA	PARDMASF
V:Part:DD-:act:p:msD	PARDMDSF
V:Part:DD-:act:p:msG	PARDMGSF
V:Part:DD-:act:p:msI	PARDMISF
V:Part:DD-:act:p:msL	PARDMLSF
V:Part:DD-:act:p:msN	PARDMNSF
V:Part:DD-:act:p:nsA	PARDNASF
V:Part:DD-:act:p:nsD	PARDNDSF
V:Part:DD-:act:p:nsG	PARDNGSF
V:Part:DD-:act:p:nsI	PARDNISF
V:Part:DD-:act:p:nsL	PARDNLSF
V:Part:DD-:act:p:nsN	PARDNNSF
	
V:Part:DI-:act:p:0pA	PARDXAPF
V:Part:DI-:act:p:0pD	PARDXDPF
V:Part:DI-:act:p:0pG	PARDXGPF
V:Part:DI-:act:p:0pI	PARDXIPF
V:Part:DI-:act:p:0pL	PARDXLPF
V:Part:DI-:act:p:0pN	PARDXNPF
V:Part:DI-:act:p:fsA	PARDFASF
V:Part:DI-:act:p:fsD	PARDFDSF
V:Part:DI-:act:p:fsG	PARDFGSF
V:Part:DI-:act:p:fsI	PARDFISF
V:Part:DI-:act:p:fsL	PARDFLSF
V:Part:DI-:act:p:fsN	PARDFNSF
V:Part:DI-:act:p:msA	PARDMASF
V:Part:DI-:act:p:msD	PARDMDSF
V:Part:DI-:act:p:msG	PARDMGSF
V:Part:DI-:act:p:msI	PARDMISF
V:Part:DI-:act:p:msL	PARDMLSF
V:Part:DI-:act:p:msN	PARDMNSF
V:Part:DI-:act:p:nsA	PARDNASF
V:Part:DI-:act:p:nsD	PARDNDSF
V:Part:DI-:act:p:nsG	PARDNGSF
V:Part:DI-:act:p:nsI	PARDNISF
V:Part:DI-:act:p:nsL	PARDNLSF
V:Part:DI-:act:p:nsN	PARDNNSF
	
V:Part:DI+:act:p:0pA	PARDXAPF
V:Part:DI+:act:p:0pD	PARDXDPF
V:Part:DI+:act:p:0pG	PARDXGPF
V:Part:DI+:act:p:0pI	PARDXIPF
V:Part:DI+:act:p:0pL	PARDXLPF
V:Part:DI+:act:p:0pN	PARDXNPF
V:Part:DI+:act:p:fsA	PARDFASF
V:Part:DI+:act:p:fsD	PARDFDSF
V:Part:DI+:act:p:fsG	PARDFGSF
V:Part:DI+:act:p:fsI	PARDFISF
V:Part:DI+:act:p:fsL	PARDFLSF
V:Part:DI+:act:p:fsN	PARDFNSF
V:Part:DI+:act:p:msA	PARDMASF
V:Part:DI+:act:p:msD	PARDMDSF
V:Part:DI+:act:p:msG	PARDMGSF
V:Part:DI+:act:p:msI	PARDMISF
V:Part:DI+:act:p:msL	PARDMLSF
V:Part:DI+:act:p:msN	PARDMNSF
V:Part:DI+:act:p:nsA	PARDNASF
V:Part:DI+:act:p:nsD	PARDNDSF
V:Part:DI+:act:p:nsG	PARDNGSF
V:Part:DI+:act:p:nsI	PARDNISF
V:Part:DI+:act:p:nsL	PARDNLSF
V:Part:DI+:act:p:nsN	PARDNNSF
	
V:Part:DT-:act:p:0pA	PARDXAPF
V:Part:DT-:act:p:0pD	PARDXDPF
V:Part:DT-:act:p:0pG	PARDXGPF
V:Part:DT-:act:p:0pI	PARDXIPF
V:Part:DT-:act:p:0pL	PARDXLPF
V:Part:DT-:act:p:0pN	PARDXNPF
V:Part:DT-:act:p:fsA	PARDFASF
V:Part:DT-:act:p:fsD	PARDFDSF
V:Part:DT-:act:p:fsG	PARDFGSF
V:Part:DT-:act:p:fsI	PARDFISF
V:Part:DT-:act:p:fsL	PARDFLSF
V:Part:DT-:act:p:fsN	PARDFNSF
V:Part:DT-:act:p:msA	PARDMASF
V:Part:DT-:act:p:msD	PARDMDSF
V:Part:DT-:act:p:msG	PARDMGSF
V:Part:DT-:act:p:msI	PARDMISF
V:Part:DT-:act:p:msL	PARDMLSF
V:Part:DT-:act:p:msN	PARDMNSF
V:Part:DT-:act:p:nsA	PARDNASF
V:Part:DT-:act:p:nsD	PARDNDSF
V:Part:DT-:act:p:nsG	PARDNGSF
V:Part:DT-:act:p:nsI	PARDNISF
V:Part:DT-:act:p:nsL	PARDNLSF
V:Part:DT-:act:p:nsN	PARDNNSF
	
V:Part:ID-:act:p:0pA	PARIXAPF
V:Part:ID-:act:p:0pD	PARIXDPF
V:Part:ID-:act:p:0pG	PARIXGPF
V:Part:ID-:act:p:0pI	PARIXIPF
V:Part:ID-:act:p:0pL	PARIXLPF
V:Part:ID-:act:p:0pN	PARIXNPF
V:Part:ID-:act:p:fsA	PARIFASF
V:Part:ID-:act:p:fsD	PARIFDSF
V:Part:ID-:act:p:fsG	PARIFGSF
V:Part:ID-:act:p:fsI	PARIFISF
V:Part:ID-:act:p:fsL	PARIFLSF
V:Part:ID-:act:p:fsN	PARIFNSF
V:Part:ID-:act:p:msA	PARIMASF
V:Part:ID-:act:p:msD	PARIMDSF
V:Part:ID-:act:p:msG	PARIMGSF
V:Part:ID-:act:p:msI	PARIMISF
V:Part:ID-:act:p:msL	PARIMLSF
V:Part:ID-:act:p:msN	PARIMNSF
V:Part:ID-:act:p:nsA	PARINASF
V:Part:ID-:act:p:nsD	PARINDSF
V:Part:ID-:act:p:nsG	PARINGSF
V:Part:ID-:act:p:nsI	PARINISF
V:Part:ID-:act:p:nsL	PARINLSF
V:Part:ID-:act:p:nsN	PARINNSF
	
V:Part:II-:act:p:0pA	PARIXAPF
V:Part:II-:act:p:0pD	PARIXDPF
V:Part:II-:act:p:0pG	PARIXGPF
V:Part:II-:act:p:0pI	PARIXIPF
V:Part:II-:act:p:0pL	PARIXLPF
V:Part:II-:act:p:0pN	PARIXNPF
V:Part:II-:act:p:fsA	PARIFASF
V:Part:II-:act:p:fsD	PARIFDSF
V:Part:II-:act:p:fsG	PARIFGSF
V:Part:II-:act:p:fsI	PARIFISF
V:Part:II-:act:p:fsL	PARIFLSF
V:Part:II-:act:p:fsN	PARIFNSF
V:Part:II-:act:p:msA	PARIMASF
V:Part:II-:act:p:msD	PARIMDSF
V:Part:II-:act:p:msG	PARIMGSF
V:Part:II-:act:p:msI	PARIMISF
V:Part:II-:act:p:msL	PARIMLSF
V:Part:II-:act:p:msN	PARIMNSF
V:Part:II-:act:p:nsA	PARINASF
V:Part:II-:act:p:nsD	PARINDSF
V:Part:II-:act:p:nsG	PARINGSF
V:Part:II-:act:p:nsI	PARINISF
V:Part:II-:act:p:nsL	PARINLSF
V:Part:II-:act:p:nsN	PARINNSF
	
V:Part:II+:act:p:0pA	PARIXAPF
V:Part:II+:act:p:0pD	PARIXDPF
V:Part:II+:act:p:0pG	PARIXGPF
V:Part:II+:act:p:0pI	PARIXIPF
V:Part:II+:act:p:0pL	PARIXLPF
V:Part:II+:act:p:0pN	PARIXNPF
V:Part:II+:act:p:fsA	PARIFASF
V:Part:II+:act:p:fsD	PARIFDSF
V:Part:II+:act:p:fsG	PARIFGSF
V:Part:II+:act:p:fsI	PARIFISF
V:Part:II+:act:p:fsL	PARIFLSF
V:Part:II+:act:p:fsN	PARIFNSF
V:Part:II+:act:p:msA	PARIMASF
V:Part:II+:act:p:msD	PARIMDSF
V:Part:II+:act:p:msG	PARIMGSF
V:Part:II+:act:p:msI	PARIMISF
V:Part:II+:act:p:msL	PARIMLSF
V:Part:II+:act:p:msN	PARIMNSF
V:Part:II+:act:p:nsA	PARINASF
V:Part:II+:act:p:nsD	PARINDSF
V:Part:II+:act:p:nsG	PARINGSF
V:Part:II+:act:p:nsI	PARINISF
V:Part:II+:act:p:nsL	PARINLSF
V:Part:II+:act:p:nsN	PARINNSF
	
V:Part:IT-:act:p:0pA	PARIXAPF
V:Part:IT-:act:p:0pD	PARIXDPF
V:Part:IT-:act:p:0pG	PARIXGPF
V:Part:IT-:act:p:0pI	PARIXIPF
V:Part:IT-:act:p:0pL	PARIXLPF
V:Part:IT-:act:p:0pN	PARIXNPF
V:Part:IT-:act:p:fsA	PARIFASF
V:Part:IT-:act:p:fsD	PARIFDSF
V:Part:IT-:act:p:fsG	PARIFGSF
V:Part:IT-:act:p:fsI	PARIFISF
V:Part:IT-:act:p:fsL	PARIFLSF
V:Part:IT-:act:p:fsN	PARIFNSF
V:Part:IT-:act:p:msA	PARIMASF
V:Part:IT-:act:p:msD	PARIMDSF
V:Part:IT-:act:p:msG	PARIMGSF
V:Part:IT-:act:p:msI	PARIMISF
V:Part:IT-:act:p:msL	PARIMLSF
V:Part:IT-:act:p:msN	PARIMNSF
V:Part:IT-:act:p:nsA	PARINASF
V:Part:IT-:act:p:nsD	PARINDSF
V:Part:IT-:act:p:nsG	PARINGSF
V:Part:IT-:act:p:nsI	PARINISF
V:Part:IT-:act:p:nsL	PARINLSF
V:Part:IT-:act:p:nsN	PARINNSF
	
V:Part:IT+:act:p:0pA	PARIXAPF
V:Part:IT+:act:p:0pD	PARIXDPF
V:Part:IT+:act:p:0pG	PARIXGPF
V:Part:IT+:act:p:0pI	PARIXIPF
V:Part:IT+:act:p:0pL	PARIXLPF
V:Part:IT+:act:p:0pN	PARIXNPF
V:Part:IT+:act:p:fsA	PARIFASF
V:Part:IT+:act:p:fsD	PARIFDSF
V:Part:IT+:act:p:fsG	PARIFGSF
V:Part:IT+:act:p:fsI	PARIFISF
V:Part:IT+:act:p:fsL	PARIFLSF
V:Part:IT+:act:p:fsN	PARIFNSF
V:Part:IT+:act:p:msA	PARIMASF
V:Part:IT+:act:p:msD	PARIMDSF
V:Part:IT+:act:p:msG	PARIMGSF
V:Part:IT+:act:p:msI	PARIMISF
V:Part:IT+:act:p:msL	PARIMLSF
V:Part:IT+:act:p:msN	PARIMNSF
V:Part:IT+:act:p:nsA	PARINASF
V:Part:IT+:act:p:nsD	PARINDSF
V:Part:IT+:act:p:nsG	PARINGSF
V:Part:IT+:act:p:nsI	PARINISF
V:Part:IT+:act:p:nsL	PARINLSF
V:Part:IT+:act:p:nsN	PARINNSF

V:Part:PD-:act:p:0pA	PARPXAPF
V:Part:PD-:act:p:0pD	PARPXDPF
V:Part:PD-:act:p:0pG	PARPXGPF
V:Part:PD-:act:p:0pI	PARPXIPF
V:Part:PD-:act:p:0pL	PARPXLPF
V:Part:PD-:act:p:0pN	PARPXNPF
V:Part:PD-:act:p:fsA	PARPFASF
V:Part:PD-:act:p:fsD	PARPFDSF
V:Part:PD-:act:p:fsG	PARPFGSF
V:Part:PD-:act:p:fsI	PARPFISF
V:Part:PD-:act:p:fsL	PARPFLSF
V:Part:PD-:act:p:fsN	PARPFNSF
V:Part:PD-:act:p:msA	PARPMASF
V:Part:PD-:act:p:msD	PARPMDSF
V:Part:PD-:act:p:msG	PARPMGSF
V:Part:PD-:act:p:msI	PARPMISF
V:Part:PD-:act:p:msL	PARPMLSF
V:Part:PD-:act:p:msN	PARPMNSF
V:Part:PD-:act:p:nsA	PARPNASF
V:Part:PD-:act:p:nsD	PARPNDSF
V:Part:PD-:act:p:nsG	PARPNGSF
V:Part:PD-:act:p:nsI	PARPNISF
V:Part:PD-:act:p:nsL	PARPNLSF
V:Part:PD-:act:p:nsN	PARPNNSF

V:Part:PI-:act:p:0pA	PARPXAPF
V:Part:PI-:act:p:0pD	PARPXDPF
V:Part:PI-:act:p:0pG	PARPXGPF
V:Part:PI-:act:p:0pI	PARPXIPF
V:Part:PI-:act:p:0pL	PARPXLPF
V:Part:PI-:act:p:0pN	PARPXNPF
V:Part:PI-:act:p:fsA	PARPFASF
V:Part:PI-:act:p:fsD	PARPFDSF
V:Part:PI-:act:p:fsG	PARPFGSF
V:Part:PI-:act:p:fsI	PARPFISF
V:Part:PI-:act:p:fsL	PARPFLSF
V:Part:PI-:act:p:fsN	PARPFNSF
V:Part:PI-:act:p:msA	PARPMASF
V:Part:PI-:act:p:msD	PARPMDSF
V:Part:PI-:act:p:msG	PARPMGSF
V:Part:PI-:act:p:msI	PARPMISF
V:Part:PI-:act:p:msL	PARPMLSF
V:Part:PI-:act:p:msN	PARPMNSF
V:Part:PI-:act:p:nsA	PARPNASF
V:Part:PI-:act:p:nsD	PARPNDSF
V:Part:PI-:act:p:nsG	PARPNGSF
V:Part:PI-:act:p:nsI	PARPNISF
V:Part:PI-:act:p:nsL	PARPNLSF
V:Part:PI-:act:p:nsN	PARPNNSF

V:Part:PI+:act:p:0pA	PARPXAPF
V:Part:PI+:act:p:0pD	PARPXDPF
V:Part:PI+:act:p:0pG	PARPXGPF
V:Part:PI+:act:p:0pI	PARPXIPF
V:Part:PI+:act:p:0pL	PARPXLPF
V:Part:PI+:act:p:0pN	PARPXNPF
V:Part:PI+:act:p:fsA	PARPFASF
V:Part:PI+:act:p:fsD	PARPFDSF
V:Part:PI+:act:p:fsG	PARPFGSF
V:Part:PI+:act:p:fsI	PARPFISF
V:Part:PI+:act:p:fsL	PARPFLSF
V:Part:PI+:act:p:fsN	PARPFNSF
V:Part:PI+:act:p:msA	PARPMASF
V:Part:PI+:act:p:msD	PARPMDSF
V:Part:PI+:act:p:msG	PARPMGSF
V:Part:PI+:act:p:msI	PARPMISF
V:Part:PI+:act:p:msL	PARPMLSF
V:Part:PI+:act:p:msN	PARPMNSF
V:Part:PI+:act:p:nsA	PARPNASF
V:Part:PI+:act:p:nsD	PARPNDSF
V:Part:PI+:act:p:nsG	PARPNGSF
V:Part:PI+:act:p:nsI	PARPNISF
V:Part:PI+:act:p:nsL	PARPNLSF
V:Part:PI+:act:p:nsN	PARPNNSF

V:Part:PT-:act:p:0pA	PARPXAPF
V:Part:PT-:act:p:0pD	PARPXDPF
V:Part:PT-:act:p:0pG	PARPXGPF
V:Part:PT-:act:p:0pI	PARPXIPF
V:Part:PT-:act:p:0pL	PARPXLPF
V:Part:PT-:act:p:0pN	PARPXNPF
V:Part:PT-:act:p:fsA	PARPFASF
V:Part:PT-:act:p:fsD	PARPFDSF
V:Part:PT-:act:p:fsG	PARPFGSF
V:Part:PT-:act:p:fsI	PARPFISF
V:Part:PT-:act:p:fsL	PARPFLSF
V:Part:PT-:act:p:fsN	PARPFNSF
V:Part:PT-:act:p:msA	PARPMASF
V:Part:PT-:act:p:msD	PARPMDSF
V:Part:PT-:act:p:msG	PARPMGSF
V:Part:PT-:act:p:msI	PARPMISF
V:Part:PT-:act:p:msL	PARPMLSF
V:Part:PT-:act:p:msN	PARPMNSF
V:Part:PT-:act:p:nsA	PARPNASF
V:Part:PT-:act:p:nsD	PARPNDSF
V:Part:PT-:act:p:nsG	PARPNGSF
V:Part:PT-:act:p:nsI	PARPNISF
V:Part:PT-:act:p:nsL	PARPNLSF
V:Part:PT-:act:p:nsN	PARPNNSF

V:Part:PT+:act:p:0pA	PARPXAPF
V:Part:PT+:act:p:0pD	PARPXDPF
V:Part:PT+:act:p:0pG	PARPXGPF
V:Part:PT+:act:p:0pI	PARPXIPF
V:Part:PT+:act:p:0pL	PARPXLPF
V:Part:PT+:act:p:0pN	PARPXNPF
V:Part:PT+:act:p:fsA	PARPFASF
V:Part:PT+:act:p:fsD	PARPFDSF
V:Part:PT+:act:p:fsG	PARPFGSF
V:Part:PT+:act:p:fsI	PARPFISF
V:Part:PT+:act:p:fsL	PARPFLSF
V:Part:PT+:act:p:fsN	PARPFNSF
V:Part:PT+:act:p:msA	PARPMASF
V:Part:PT+:act:p:msD	PARPMDSF
V:Part:PT+:act:p:msG	PARPMGSF
V:Part:PT+:act:p:msI	PARPMISF
V:Part:PT+:act:p:msL	PARPMLSF
V:Part:PT+:act:p:msN	PARPMNSF
V:Part:PT+:act:p:nsA	PARPNASF
V:Part:PT+:act:p:nsD	PARPNDSF
V:Part:PT+:act:p:nsG	PARPNGSF
V:Part:PT+:act:p:nsI	PARPNISF
V:Part:PT+:act:p:nsL	PARPNLSF
V:Part:PT+:act:p:nsN	PARPNNSF

V:Part:DD-:act:a:0pA	PAPDXAPF
V:Part:DD-:act:a:0pD	PAPDXDPF
V:Part:DD-:act:a:0pG	PAPDXGPF
V:Part:DD-:act:a:0pI	PAPDXIPF
V:Part:DD-:act:a:0pL	PAPDXLPF
V:Part:DD-:act:a:0pN	PAPDXNPF
V:Part:DD-:act:a:fsA	PAPDFASF
V:Part:DD-:act:a:fsD	PAPDFDSF
V:Part:DD-:act:a:fsG	PAPDFGSF
V:Part:DD-:act:a:fsI	PAPDFISF
V:Part:DD-:act:a:fsL	PAPDFLSF
V:Part:DD-:act:a:fsN	PAPDFNSF
V:Part:DD-:act:a:msA	PAPDMASF
V:Part:DD-:act:a:msD	PAPDMDSF
V:Part:DD-:act:a:msG	PAPDMGSF
V:Part:DD-:act:a:msI	PAPDMISF
V:Part:DD-:act:a:msL	PAPDMLSF
V:Part:DD-:act:a:msN	PAPDMNSF
V:Part:DD-:act:a:nsA	PAPDNASF
V:Part:DD-:act:a:nsD	PAPDNDSF
V:Part:DD-:act:a:nsG	PAPDNGSF
V:Part:DD-:act:a:nsI	PAPDNISF
V:Part:DD-:act:a:nsL	PAPDNLSF
V:Part:DD-:act:a:nsN	PAPDNNSF
	
V:Part:DI-:act:a:0pA	PAPDXAPF
V:Part:DI-:act:a:0pD	PAPDXDPF
V:Part:DI-:act:a:0pG	PAPDXGPF
V:Part:DI-:act:a:0pI	PAPDXIPF
V:Part:DI-:act:a:0pL	PAPDXLPF
V:Part:DI-:act:a:0pN	PAPDXNPF
V:Part:DI-:act:a:fsA	PAPDFASF
V:Part:DI-:act:a:fsD	PAPDFDSF
V:Part:DI-:act:a:fsG	PAPDFGSF
V:Part:DI-:act:a:fsI	PAPDFISF
V:Part:DI-:act:a:fsL	PAPDFLSF
V:Part:DI-:act:a:fsN	PAPDFNSF
V:Part:DI-:act:a:msA	PAPDMASF
V:Part:DI-:act:a:msD	PAPDMDSF
V:Part:DI-:act:a:msG	PAPDMGSF
V:Part:DI-:act:a:msI	PAPDMISF
V:Part:DI-:act:a:msL	PAPDMLSF
V:Part:DI-:act:a:msN	PAPDMNSF
V:Part:DI-:act:a:nsA	PAPDNASF
V:Part:DI-:act:a:nsD	PAPDNDSF
V:Part:DI-:act:a:nsG	PAPDNGSF
V:Part:DI-:act:a:nsI	PAPDNISF
V:Part:DI-:act:a:nsL	PAPDNLSF
V:Part:DI-:act:a:nsN	PAPDNNSF
	
V:Part:DI+:act:a:0pA	PAPDXAPF
V:Part:DI+:act:a:0pD	PAPDXDPF
V:Part:DI+:act:a:0pG	PAPDXGPF
V:Part:DI+:act:a:0pI	PAPDXIPF
V:Part:DI+:act:a:0pL	PAPDXLPF
V:Part:DI+:act:a:0pN	PAPDXNPF
V:Part:DI+:act:a:fsA	PAPDFASF
V:Part:DI+:act:a:fsD	PAPDFDSF
V:Part:DI+:act:a:fsG	PAPDFGSF
V:Part:DI+:act:a:fsI	PAPDFISF
V:Part:DI+:act:a:fsL	PAPDFLSF
V:Part:DI+:act:a:fsN	PAPDFNSF
V:Part:DI+:act:a:msA	PAPDMASF
V:Part:DI+:act:a:msD	PAPDMDSF
V:Part:DI+:act:a:msG	PAPDMGSF
V:Part:DI+:act:a:msI	PAPDMISF
V:Part:DI+:act:a:msL	PAPDMLSF
V:Part:DI+:act:a:msN	PAPDMNSF
V:Part:DI+:act:a:nsA	PAPDNASF
V:Part:DI+:act:a:nsD	PAPDNDSF
V:Part:DI+:act:a:nsG	PAPDNGSF
V:Part:DI+:act:a:nsI	PAPDNISF
V:Part:DI+:act:a:nsL	PAPDNLSF
V:Part:DI+:act:a:nsN	PAPDNNSF
	
V:Part:DT-:act:a:0pA	PAPDXAPF
V:Part:DT-:act:a:0pD	PAPDXDPF
V:Part:DT-:act:a:0pG	PAPDXGPF
V:Part:DT-:act:a:0pI	PAPDXIPF
V:Part:DT-:act:a:0pL	PAPDXLPF
V:Part:DT-:act:a:0pN	PAPDXNPF
V:Part:DT-:act:a:fsA	PAPDFASF
V:Part:DT-:act:a:fsD	PAPDFDSF
V:Part:DT-:act:a:fsG	PAPDFGSF
V:Part:DT-:act:a:fsI	PAPDFISF
V:Part:DT-:act:a:fsL	PAPDFLSF
V:Part:DT-:act:a:fsN	PAPDFNSF
V:Part:DT-:act:a:msA	PAPDMASF
V:Part:DT-:act:a:msD	PAPDMDSF
V:Part:DT-:act:a:msG	PAPDMGSF
V:Part:DT-:act:a:msI	PAPDMISF
V:Part:DT-:act:a:msL	PAPDMLSF
V:Part:DT-:act:a:msN	PAPDMNSF
V:Part:DT-:act:a:nsA	PAPDNASF
V:Part:DT-:act:a:nsD	PAPDNDSF
V:Part:DT-:act:a:nsG	PAPDNGSF
V:Part:DT-:act:a:nsI	PAPDNISF
V:Part:DT-:act:a:nsL	PAPDNLSF
V:Part:DT-:act:a:nsN	PAPDNNSF
	
V:Part:ID-:act:a:0pA	PAPIXAPF
V:Part:ID-:act:a:0pD	PAPIXDPF
V:Part:ID-:act:a:0pG	PAPIXGPF
V:Part:ID-:act:a:0pI	PAPIXIPF
V:Part:ID-:act:a:0pL	PAPIXLPF
V:Part:ID-:act:a:0pN	PAPIXNPF
V:Part:ID-:act:a:fsA	PAPIFASF
V:Part:ID-:act:a:fsD	PAPIFDSF
V:Part:ID-:act:a:fsG	PAPIFGSF
V:Part:ID-:act:a:fsI	PAPIFISF
V:Part:ID-:act:a:fsL	PAPIFLSF
V:Part:ID-:act:a:fsN	PAPIFNSF
V:Part:ID-:act:a:msA	PAPIMASF
V:Part:ID-:act:a:msD	PAPIMDSF
V:Part:ID-:act:a:msG	PAPIMGSF
V:Part:ID-:act:a:msI	PAPIMISF
V:Part:ID-:act:a:msL	PAPIMLSF
V:Part:ID-:act:a:msN	PAPIMNSF
V:Part:ID-:act:a:nsA	PAPINASF
V:Part:ID-:act:a:nsD	PAPINDSF
V:Part:ID-:act:a:nsG	PAPINGSF
V:Part:ID-:act:a:nsI	PAPINISF
V:Part:ID-:act:a:nsL	PAPINLSF
V:Part:ID-:act:a:nsN	PAPINNSF
	
V:Part:II-:act:a:0pA	PAPIXAPF
V:Part:II-:act:a:0pD	PAPIXDPF
V:Part:II-:act:a:0pG	PAPIXGPF
V:Part:II-:act:a:0pI	PAPIXIPF
V:Part:II-:act:a:0pL	PAPIXLPF
V:Part:II-:act:a:0pN	PAPIXNPF
V:Part:II-:act:a:fsA	PAPIFASF
V:Part:II-:act:a:fsD	PAPIFDSF
V:Part:II-:act:a:fsG	PAPIFGSF
V:Part:II-:act:a:fsI	PAPIFISF
V:Part:II-:act:a:fsL	PAPIFLSF
V:Part:II-:act:a:fsN	PAPIFNSF
V:Part:II-:act:a:msA	PAPIMASF
V:Part:II-:act:a:msD	PAPIMDSF
V:Part:II-:act:a:msG	PAPIMGSF
V:Part:II-:act:a:msI	PAPIMISF
V:Part:II-:act:a:msL	PAPIMLSF
V:Part:II-:act:a:msN	PAPIMNSF
V:Part:II-:act:a:nsA	PAPINASF
V:Part:II-:act:a:nsD	PAPINDSF
V:Part:II-:act:a:nsG	PAPINGSF
V:Part:II-:act:a:nsI	PAPINISF
V:Part:II-:act:a:nsL	PAPINLSF
V:Part:II-:act:a:nsN	PAPINNSF
	
V:Part:II+:act:a:0pA	PAPIXAPF
V:Part:II+:act:a:0pD	PAPIXDPF
V:Part:II+:act:a:0pG	PAPIXGPF
V:Part:II+:act:a:0pI	PAPIXIPF
V:Part:II+:act:a:0pL	PAPIXLPF
V:Part:II+:act:a:0pN	PAPIXNPF
V:Part:II+:act:a:fsA	PAPIFASF
V:Part:II+:act:a:fsD	PAPIFDSF
V:Part:II+:act:a:fsG	PAPIFGSF
V:Part:II+:act:a:fsI	PAPIFISF
V:Part:II+:act:a:fsL	PAPIFLSF
V:Part:II+:act:a:fsN	PAPIFNSF
V:Part:II+:act:a:msA	PAPIMASF
V:Part:II+:act:a:msD	PAPIMDSF
V:Part:II+:act:a:msG	PAPIMGSF
V:Part:II+:act:a:msI	PAPIMISF
V:Part:II+:act:a:msL	PAPIMLSF
V:Part:II+:act:a:msN	PAPIMNSF
V:Part:II+:act:a:nsA	PAPINASF
V:Part:II+:act:a:nsD	PAPINDSF
V:Part:II+:act:a:nsG	PAPINGSF
V:Part:II+:act:a:nsI	PAPINISF
V:Part:II+:act:a:nsL	PAPINLSF
V:Part:II+:act:a:nsN	PAPINNSF
	
V:Part:IT-:act:a:0pA	PAPIXAPF
V:Part:IT-:act:a:0pD	PAPIXDPF
V:Part:IT-:act:a:0pG	PAPIXGPF
V:Part:IT-:act:a:0pI	PAPIXIPF
V:Part:IT-:act:a:0pL	PAPIXLPF
V:Part:IT-:act:a:0pN	PAPIXNPF
V:Part:IT-:act:a:fsA	PAPIFASF
V:Part:IT-:act:a:fsD	PAPIFDSF
V:Part:IT-:act:a:fsG	PAPIFGSF
V:Part:IT-:act:a:fsI	PAPIFISF
V:Part:IT-:act:a:fsL	PAPIFLSF
V:Part:IT-:act:a:fsN	PAPIFNSF
V:Part:IT-:act:a:msA	PAPIMASF
V:Part:IT-:act:a:msD	PAPIMDSF
V:Part:IT-:act:a:msG	PAPIMGSF
V:Part:IT-:act:a:msI	PAPIMISF
V:Part:IT-:act:a:msL	PAPIMLSF
V:Part:IT-:act:a:msN	PAPIMNSF
V:Part:IT-:act:a:nsA	PAPINASF
V:Part:IT-:act:a:nsD	PAPINDSF
V:Part:IT-:act:a:nsG	PAPINGSF
V:Part:IT-:act:a:nsI	PAPINISF
V:Part:IT-:act:a:nsL	PAPINLSF
V:Part:IT-:act:a:nsN	PAPINNSF
	
V:Part:IT+:act:a:0pA	PAPIXAPF
V:Part:IT+:act:a:0pD	PAPIXDPF
V:Part:IT+:act:a:0pG	PAPIXGPF
V:Part:IT+:act:a:0pI	PAPIXIPF
V:Part:IT+:act:a:0pL	PAPIXLPF
V:Part:IT+:act:a:0pN	PAPIXNPF
V:Part:IT+:act:a:fsA	PAPIFASF
V:Part:IT+:act:a:fsD	PAPIFDSF
V:Part:IT+:act:a:fsG	PAPIFGSF
V:Part:IT+:act:a:fsI	PAPIFISF
V:Part:IT+:act:a:fsL	PAPIFLSF
V:Part:IT+:act:a:fsN	PAPIFNSF
V:Part:IT+:act:a:msA	PAPIMASF
V:Part:IT+:act:a:msD	PAPIMDSF
V:Part:IT+:act:a:msG	PAPIMGSF
V:Part:IT+:act:a:msI	PAPIMISF
V:Part:IT+:act:a:msL	PAPIMLSF
V:Part:IT+:act:a:msN	PAPIMNSF
V:Part:IT+:act:a:nsA	PAPINASF
V:Part:IT+:act:a:nsD	PAPINDSF
V:Part:IT+:act:a:nsG	PAPINGSF
V:Part:IT+:act:a:nsI	PAPINISF
V:Part:IT+:act:a:nsL	PAPINLSF
V:Part:IT+:act:a:nsN	PAPINNSF
	
V:Part:PD-:act:a:0pA	PAPPXAPF
V:Part:PD-:act:a:0pD	PAPPXDPF
V:Part:PD-:act:a:0pG	PAPPXGPF
V:Part:PD-:act:a:0pI	PAPPXIPF
V:Part:PD-:act:a:0pL	PAPPXLPF
V:Part:PD-:act:a:0pN	PAPPXNPF
V:Part:PD-:act:a:fsA	PAPPFASF
V:Part:PD-:act:a:fsD	PAPPFDSF
V:Part:PD-:act:a:fsG	PAPPFGSF
V:Part:PD-:act:a:fsI	PAPPFISF
V:Part:PD-:act:a:fsL	PAPPFLSF
V:Part:PD-:act:a:fsN	PAPPFNSF
V:Part:PD-:act:a:msA	PAPPMASF
V:Part:PD-:act:a:msD	PAPPMDSF
V:Part:PD-:act:a:msG	PAPPMGSF
V:Part:PD-:act:a:msI	PAPPMISF
V:Part:PD-:act:a:msL	PAPPMLSF
V:Part:PD-:act:a:msN	PAPPMNSF
V:Part:PD-:act:a:nsA	PAPPNASF
V:Part:PD-:act:a:nsD	PAPPNDSF
V:Part:PD-:act:a:nsG	PAPPNGSF
V:Part:PD-:act:a:nsI	PAPPNISF
V:Part:PD-:act:a:nsL	PAPPNLSF
V:Part:PD-:act:a:nsN	PAPPNNSF
	
V:Part:PI-:act:a:0pA	PAPPXAPF
V:Part:PI-:act:a:0pD	PAPPXDPF
V:Part:PI-:act:a:0pG	PAPPXGPF
V:Part:PI-:act:a:0pI	PAPPXIPF
V:Part:PI-:act:a:0pL	PAPPXLPF
V:Part:PI-:act:a:0pN	PAPPXNPF
V:Part:PI-:act:a:fsA	PAPPFASF
V:Part:PI-:act:a:fsD	PAPPFDSF
V:Part:PI-:act:a:fsG	PAPPFGSF
V:Part:PI-:act:a:fsI	PAPPFISF
V:Part:PI-:act:a:fsL	PAPPFLSF
V:Part:PI-:act:a:fsN	PAPPFNSF
V:Part:PI-:act:a:msA	PAPPMASF
V:Part:PI-:act:a:msD	PAPPMDSF
V:Part:PI-:act:a:msG	PAPPMGSF
V:Part:PI-:act:a:msI	PAPPMISF
V:Part:PI-:act:a:msL	PAPPMLSF
V:Part:PI-:act:a:msN	PAPPMNSF
V:Part:PI-:act:a:nsA	PAPPNASF
V:Part:PI-:act:a:nsD	PAPPNDSF
V:Part:PI-:act:a:nsG	PAPPNGSF
V:Part:PI-:act:a:nsI	PAPPNISF
V:Part:PI-:act:a:nsL	PAPPNLSF
V:Part:PI-:act:a:nsN	PAPPNNSF
	
V:Part:PI+:act:a:0pA	PAPPXAPF
V:Part:PI+:act:a:0pD	PAPPXDPF
V:Part:PI+:act:a:0pG	PAPPXGPF
V:Part:PI+:act:a:0pI	PAPPXIPF
V:Part:PI+:act:a:0pL	PAPPXLPF
V:Part:PI+:act:a:0pN	PAPPXNPF
V:Part:PI+:act:a:fsA	PAPPFASF
V:Part:PI+:act:a:fsD	PAPPFDSF
V:Part:PI+:act:a:fsG	PAPPFGSF
V:Part:PI+:act:a:fsI	PAPPFISF
V:Part:PI+:act:a:fsL	PAPPFLSF
V:Part:PI+:act:a:fsN	PAPPFNSF
V:Part:PI+:act:a:msA	PAPPMASF
V:Part:PI+:act:a:msD	PAPPMDSF
V:Part:PI+:act:a:msG	PAPPMGSF
V:Part:PI+:act:a:msI	PAPPMISF
V:Part:PI+:act:a:msL	PAPPMLSF
V:Part:PI+:act:a:msN	PAPPMNSF
V:Part:PI+:act:a:nsA	PAPPNASF
V:Part:PI+:act:a:nsD	PAPPNDSF
V:Part:PI+:act:a:nsG	PAPPNGSF
V:Part:PI+:act:a:nsI	PAPPNISF
V:Part:PI+:act:a:nsL	PAPPNLSF
V:Part:PI+:act:a:nsN	PAPPNNSF
	
V:Part:PT-:act:a:0pA	PAPPXAPF
V:Part:PT-:act:a:0pD	PAPPXDPF
V:Part:PT-:act:a:0pG	PAPPXGPF
V:Part:PT-:act:a:0pI	PAPPXIPF
V:Part:PT-:act:a:0pL	PAPPXLPF
V:Part:PT-:act:a:0pN	PAPPXNPF
V:Part:PT-:act:a:fsA	PAPPFASF
V:Part:PT-:act:a:fsD	PAPPFDSF
V:Part:PT-:act:a:fsG	PAPPFGSF
V:Part:PT-:act:a:fsI	PAPPFISF
V:Part:PT-:act:a:fsL	PAPPFLSF
V:Part:PT-:act:a:fsN	PAPPFNSF
V:Part:PT-:act:a:msA	PAPPMASF
V:Part:PT-:act:a:msD	PAPPMDSF
V:Part:PT-:act:a:msG	PAPPMGSF
V:Part:PT-:act:a:msI	PAPPMISF
V:Part:PT-:act:a:msL	PAPPMLSF
V:Part:PT-:act:a:msN	PAPPMNSF
V:Part:PT-:act:a:nsA	PAPPNASF
V:Part:PT-:act:a:nsD	PAPPNDSF
V:Part:PT-:act:a:nsG	PAPPNGSF
V:Part:PT-:act:a:nsI	PAPPNISF
V:Part:PT-:act:a:nsL	PAPPNLSF
V:Part:PT-:act:a:nsN	PAPPNNSF
	
V:Part:PT+:act:a:0pA	PAPPXAPF
V:Part:PT+:act:a:0pD	PAPPXDPF
V:Part:PT+:act:a:0pG	PAPPXGPF
V:Part:PT+:act:a:0pI	PAPPXIPF
V:Part:PT+:act:a:0pL	PAPPXLPF
V:Part:PT+:act:a:0pN	PAPPXNPF
V:Part:PT+:act:a:fsA	PAPPFASF
V:Part:PT+:act:a:fsD	PAPPFDSF
V:Part:PT+:act:a:fsG	PAPPFGSF
V:Part:PT+:act:a:fsI	PAPPFISF
V:Part:PT+:act:a:fsL	PAPPFLSF
V:Part:PT+:act:a:fsN	PAPPFNSF
V:Part:PT+:act:a:msA	PAPPMASF
V:Part:PT+:act:a:msD	PAPPMDSF
V:Part:PT+:act:a:msG	PAPPMGSF
V:Part:PT+:act:a:msI	PAPPMISF
V:Part:PT+:act:a:msL	PAPPMLSF
V:Part:PT+:act:a:msN	PAPPMNSF
V:Part:PT+:act:a:nsA	PAPPNASF
V:Part:PT+:act:a:nsD	PAPPNDSF
V:Part:PT+:act:a:nsG	PAPPNGSF
V:Part:PT+:act:a:nsI	PAPPNISF
V:Part:PT+:act:a:nsL	PAPPNLSF
V:Part:PT+:act:a:nsN	PAPPNNSF

V:Part:DD-:pass:0pA	PPXDXAPF
V:Part:DD-:pass:0pD	PPXDXDPF
V:Part:DD-:pass:0pG	PPXDXGPF
V:Part:DD-:pass:0pI	PPXDXIPF
V:Part:DD-:pass:0pL	PPXDXLPF
V:Part:DD-:pass:0pN	PPXDXNPF
V:Part:DD-:pass:fsA	PPXDFASF
V:Part:DD-:pass:fsD	PPXDFDSF
V:Part:DD-:pass:fsG	PPXDFGSF
V:Part:DD-:pass:fsI	PPXDFISF
V:Part:DD-:pass:fsL	PPXDFLSF
V:Part:DD-:pass:fsN	PPXDFNSF
V:Part:DD-:pass:msA	PPXDMASF
V:Part:DD-:pass:msD	PPXDMDSF
V:Part:DD-:pass:msG	PPXDMGSF
V:Part:DD-:pass:msI	PPXDMISF
V:Part:DD-:pass:msL	PPXDMLSF
V:Part:DD-:pass:msN	PPXDMNSF
V:Part:DD-:pass:nsA	PPXDNASF
V:Part:DD-:pass:nsD	PPXDNDSF
V:Part:DD-:pass:nsG	PPXDNGSF
V:Part:DD-:pass:nsI	PPXDNISF
V:Part:DD-:pass:nsL	PPXDNLSF
V:Part:DD-:pass:nsN	PPXDNNSF
	
V:Part:DI-:pass:0pA	PPXDXAPF
V:Part:DI-:pass:0pD	PPXDXDPF
V:Part:DI-:pass:0pG	PPXDXGPF
V:Part:DI-:pass:0pI	PPXDXIPF
V:Part:DI-:pass:0pL	PPXDXLPF
V:Part:DI-:pass:0pN	PPXDXNPF
V:Part:DI-:pass:fsA	PPXDFASF
V:Part:DI-:pass:fsD	PPXDFDSF
V:Part:DI-:pass:fsG	PPXDFGSF
V:Part:DI-:pass:fsI	PPXDFISF
V:Part:DI-:pass:fsL	PPXDFLSF
V:Part:DI-:pass:fsN	PPXDFNSF
V:Part:DI-:pass:msA	PPXDMASF
V:Part:DI-:pass:msD	PPXDMDSF
V:Part:DI-:pass:msG	PPXDMGSF
V:Part:DI-:pass:msI	PPXDMISF
V:Part:DI-:pass:msL	PPXDMLSF
V:Part:DI-:pass:msN	PPXDMNSF
V:Part:DI-:pass:nsA	PPXDNASF
V:Part:DI-:pass:nsD	PPXDNDSF
V:Part:DI-:pass:nsG	PPXDNGSF
V:Part:DI-:pass:nsI	PPXDNISF
V:Part:DI-:pass:nsL	PPXDNLSF
V:Part:DI-:pass:nsN	PPXDNNSF
	
V:Part:DT-:pass:0pA	PPXDXAPF
V:Part:DT-:pass:0pD	PPXDXDPF
V:Part:DT-:pass:0pG	PPXDXGPF
V:Part:DT-:pass:0pI	PPXDXIPF
V:Part:DT-:pass:0pL	PPXDXLPF
V:Part:DT-:pass:0pN	PPXDXNPF
V:Part:DT-:pass:fsA	PPXDFASF
V:Part:DT-:pass:fsD	PPXDFDSF
V:Part:DT-:pass:fsG	PPXDFGSF
V:Part:DT-:pass:fsI	PPXDFISF
V:Part:DT-:pass:fsL	PPXDFLSF
V:Part:DT-:pass:fsN	PPXDFNSF
V:Part:DT-:pass:msA	PPXDMASF
V:Part:DT-:pass:msD	PPXDMDSF
V:Part:DT-:pass:msG	PPXDMGSF
V:Part:DT-:pass:msI	PPXDMISF
V:Part:DT-:pass:msL	PPXDMLSF
V:Part:DT-:pass:msN	PPXDMNSF
V:Part:DT-:pass:nsA	PPXDNASF
V:Part:DT-:pass:nsD	PPXDNDSF
V:Part:DT-:pass:nsG	PPXDNGSF
V:Part:DT-:pass:nsI	PPXDNISF
V:Part:DT-:pass:nsL	PPXDNLSF
V:Part:DT-:pass:nsN	PPXDNNSF
	
V:Part:ID-:pass:0pA	PPXIXAPF
V:Part:ID-:pass:0pD	PPXIXDPF
V:Part:ID-:pass:0pG	PPXIXGPF
V:Part:ID-:pass:0pI	PPXIXIPF
V:Part:ID-:pass:0pL	PPXIXLPF
V:Part:ID-:pass:0pN	PPXIXNPF
V:Part:ID-:pass:fsA	PPXIFASF
V:Part:ID-:pass:fsD	PPXIFDSF
V:Part:ID-:pass:fsG	PPXIFGSF
V:Part:ID-:pass:fsI	PPXIFISF
V:Part:ID-:pass:fsL	PPXIFLSF
V:Part:ID-:pass:fsN	PPXIFNSF
V:Part:ID-:pass:msA	PPXIMASF
V:Part:ID-:pass:msD	PPXIMDSF
V:Part:ID-:pass:msG	PPXIMGSF
V:Part:ID-:pass:msI	PPXIMISF
V:Part:ID-:pass:msL	PPXIMLSF
V:Part:ID-:pass:msN	PPXIMNSF
V:Part:ID-:pass:nsA	PPXINASF
V:Part:ID-:pass:nsD	PPXINDSF
V:Part:ID-:pass:nsG	PPXINGSF
V:Part:ID-:pass:nsI	PPXINISF
V:Part:ID-:pass:nsL	PPXINLSF
V:Part:ID-:pass:nsN	PPXINNSF
	
V:Part:II-:pass:0pA	PPXIXAPF
V:Part:II-:pass:0pD	PPXIXDPF
V:Part:II-:pass:0pG	PPXIXGPF
V:Part:II-:pass:0pI	PPXIXIPF
V:Part:II-:pass:0pL	PPXIXLPF
V:Part:II-:pass:0pN	PPXIXNPF
V:Part:II-:pass:fsA	PPXIFASF
V:Part:II-:pass:fsD	PPXIFDSF
V:Part:II-:pass:fsG	PPXIFGSF
V:Part:II-:pass:fsI	PPXIFISF
V:Part:II-:pass:fsL	PPXIFLSF
V:Part:II-:pass:fsN	PPXIFNSF
V:Part:II-:pass:msA	PPXIMASF
V:Part:II-:pass:msD	PPXIMDSF
V:Part:II-:pass:msG	PPXIMGSF
V:Part:II-:pass:msI	PPXIMISF
V:Part:II-:pass:msL	PPXIMLSF
V:Part:II-:pass:msN	PPXIMNSF
V:Part:II-:pass:nsA	PPXINASF
V:Part:II-:pass:nsD	PPXINDSF
V:Part:II-:pass:nsG	PPXINGSF
V:Part:II-:pass:nsI	PPXINISF
V:Part:II-:pass:nsL	PPXINLSF
V:Part:II-:pass:nsN	PPXINNSF
	
V:Part:IT-:pass:0pA	PPXIXAPF
V:Part:IT-:pass:0pD	PPXIXDPF
V:Part:IT-:pass:0pG	PPXIXGPF
V:Part:IT-:pass:0pI	PPXIXIPF
V:Part:IT-:pass:0pL	PPXIXLPF
V:Part:IT-:pass:0pN	PPXIXNPF
V:Part:IT-:pass:fsA	PPXIFASF
V:Part:IT-:pass:fsD	PPXIFDSF
V:Part:IT-:pass:fsG	PPXIFGSF
V:Part:IT-:pass:fsI	PPXIFISF
V:Part:IT-:pass:fsL	PPXIFLSF
V:Part:IT-:pass:fsN	PPXIFNSF
V:Part:IT-:pass:msA	PPXIMASF
V:Part:IT-:pass:msD	PPXIMDSF
V:Part:IT-:pass:msG	PPXIMGSF
V:Part:IT-:pass:msI	PPXIMISF
V:Part:IT-:pass:msL	PPXIMLSF
V:Part:IT-:pass:msN	PPXIMNSF
V:Part:IT-:pass:nsA	PPXINASF
V:Part:IT-:pass:nsD	PPXINDSF
V:Part:IT-:pass:nsG	PPXINGSF
V:Part:IT-:pass:nsI	PPXINISF
V:Part:IT-:pass:nsL	PPXINLSF
V:Part:IT-:pass:nsN	PPXINNSF
	
V:Part:PD-:pass:0pA	PPXPXAPF
V:Part:PD-:pass:0pD	PPXPXDPF
V:Part:PD-:pass:0pG	PPXPXGPF
V:Part:PD-:pass:0pI	PPXPXIPF
V:Part:PD-:pass:0pL	PPXPXLPF
V:Part:PD-:pass:0pN	PPXPXNPF
V:Part:PD-:pass:fsA	PPXPFASF
V:Part:PD-:pass:fsD	PPXPFDSF
V:Part:PD-:pass:fsG	PPXPFGSF
V:Part:PD-:pass:fsI	PPXPFISF
V:Part:PD-:pass:fsL	PPXPFLSF
V:Part:PD-:pass:fsN	PPXPFNSF
V:Part:PD-:pass:msA	PPXPMASF
V:Part:PD-:pass:msD	PPXPMDSF
V:Part:PD-:pass:msG	PPXPMGSF
V:Part:PD-:pass:msI	PPXPMISF
V:Part:PD-:pass:msL	PPXPMLSF
V:Part:PD-:pass:msN	PPXPMNSF
V:Part:PD-:pass:nsA	PPXPNASF
V:Part:PD-:pass:nsD	PPXPNDSF
V:Part:PD-:pass:nsG	PPXPNGSF
V:Part:PD-:pass:nsI	PPXPNISF
V:Part:PD-:pass:nsL	PPXPNLSF
V:Part:PD-:pass:nsN	PPXPNNSF
	
V:Part:PI-:pass:0pA	PPXPXAPF
V:Part:PI-:pass:0pD	PPXPXDPF
V:Part:PI-:pass:0pG	PPXPXGPF
V:Part:PI-:pass:0pI	PPXPXIPF
V:Part:PI-:pass:0pL	PPXPXLPF
V:Part:PI-:pass:0pN	PPXPXNPF
V:Part:PI-:pass:fsA	PPXPFASF
V:Part:PI-:pass:fsD	PPXPFDSF
V:Part:PI-:pass:fsG	PPXPFGSF
V:Part:PI-:pass:fsI	PPXPFISF
V:Part:PI-:pass:fsL	PPXPFLSF
V:Part:PI-:pass:fsN	PPXPFNSF
V:Part:PI-:pass:msA	PPXPMASF
V:Part:PI-:pass:msD	PPXPMDSF
V:Part:PI-:pass:msG	PPXPMGSF
V:Part:PI-:pass:msI	PPXPMISF
V:Part:PI-:pass:msL	PPXPMLSF
V:Part:PI-:pass:msN	PPXPMNSF
V:Part:PI-:pass:nsA	PPXPNASF
V:Part:PI-:pass:nsD	PPXPNDSF
V:Part:PI-:pass:nsG	PPXPNGSF
V:Part:PI-:pass:nsI	PPXPNISF
V:Part:PI-:pass:nsL	PPXPNLSF
V:Part:PI-:pass:nsN	PPXPNNSF
	
V:Part:PT-:pass:0pA	PPXPXAPF
V:Part:PT-:pass:0pD	PPXPXDPF
V:Part:PT-:pass:0pG	PPXPXGPF
V:Part:PT-:pass:0pI	PPXPXIPF
V:Part:PT-:pass:0pL	PPXPXLPF
V:Part:PT-:pass:0pN	PPXPXNPF
V:Part:PT-:pass:fsA	PPXPFASF
V:Part:PT-:pass:fsD	PPXPFDSF
V:Part:PT-:pass:fsG	PPXPFGSF
V:Part:PT-:pass:fsI	PPXPFISF
V:Part:PT-:pass:fsL	PPXPFLSF
V:Part:PT-:pass:fsN	PPXPFNSF
V:Part:PT-:pass:msA	PPXPMASF
V:Part:PT-:pass:msD	PPXPMDSF
V:Part:PT-:pass:msG	PPXPMGSF
V:Part:PT-:pass:msI	PPXPMISF
V:Part:PT-:pass:msL	PPXPMLSF
V:Part:PT-:pass:msN	PPXPMNSF
V:Part:PT-:pass:nsA	PPXPNASF
V:Part:PT-:pass:nsD	PPXPNDSF
V:Part:PT-:pass:nsG	PPXPNGSF
V:Part:PT-:pass:nsI	PPXPNISF
V:Part:PT-:pass:nsL	PPXPNLSF
V:Part:PT-:pass:nsN	PPXPNNSF

V:Part:DD-:pass:p:0pA	PPRDXAPF
V:Part:DD-:pass:p:0pD	PPRDXDPF
V:Part:DD-:pass:p:0pG	PPRDXGPF
V:Part:DD-:pass:p:0pI	PPRDXIPF
V:Part:DD-:pass:p:0pL	PPRDXLPF
V:Part:DD-:pass:p:0pN	PPRDXNPF
V:Part:DD-:pass:p:fsA	PPRDFASF
V:Part:DD-:pass:p:fsD	PPRDFDSF
V:Part:DD-:pass:p:fsG	PPRDFGSF
V:Part:DD-:pass:p:fsI	PPRDFISF
V:Part:DD-:pass:p:fsL	PPRDFLSF
V:Part:DD-:pass:p:fsN	PPRDFNSF
V:Part:DD-:pass:p:msA	PPRDMASF
V:Part:DD-:pass:p:msD	PPRDMDSF
V:Part:DD-:pass:p:msG	PPRDMGSF
V:Part:DD-:pass:p:msI	PPRDMISF
V:Part:DD-:pass:p:msL	PPRDMLSF
V:Part:DD-:pass:p:msN	PPRDMNSF
V:Part:DD-:pass:p:nsA	PPRDNASF
V:Part:DD-:pass:p:nsD	PPRDNDSF
V:Part:DD-:pass:p:nsG	PPRDNGSF
V:Part:DD-:pass:p:nsI	PPRDNISF
V:Part:DD-:pass:p:nsL	PPRDNLSF
V:Part:DD-:pass:p:nsN	PPRDNNSF
	
V:Part:DI-:pass:p:0pA	PPRDXAPF
V:Part:DI-:pass:p:0pD	PPRDXDPF
V:Part:DI-:pass:p:0pG	PPRDXGPF
V:Part:DI-:pass:p:0pI	PPRDXIPF
V:Part:DI-:pass:p:0pL	PPRDXLPF
V:Part:DI-:pass:p:0pN	PPRDXNPF
V:Part:DI-:pass:p:fsA	PPRDFASF
V:Part:DI-:pass:p:fsD	PPRDFDSF
V:Part:DI-:pass:p:fsG	PPRDFGSF
V:Part:DI-:pass:p:fsI	PPRDFISF
V:Part:DI-:pass:p:fsL	PPRDFLSF
V:Part:DI-:pass:p:fsN	PPRDFNSF
V:Part:DI-:pass:p:msA	PPRDMASF
V:Part:DI-:pass:p:msD	PPRDMDSF
V:Part:DI-:pass:p:msG	PPRDMGSF
V:Part:DI-:pass:p:msI	PPRDMISF
V:Part:DI-:pass:p:msL	PPRDMLSF
V:Part:DI-:pass:p:msN	PPRDMNSF
V:Part:DI-:pass:p:nsA	PPRDNASF
V:Part:DI-:pass:p:nsD	PPRDNDSF
V:Part:DI-:pass:p:nsG	PPRDNGSF
V:Part:DI-:pass:p:nsI	PPRDNISF
V:Part:DI-:pass:p:nsL	PPRDNLSF
V:Part:DI-:pass:p:nsN	PPRDNNSF
	
V:Part:DT-:pass:p:0pA	PPRDXAPF
V:Part:DT-:pass:p:0pD	PPRDXDPF
V:Part:DT-:pass:p:0pG	PPRDXGPF
V:Part:DT-:pass:p:0pI	PPRDXIPF
V:Part:DT-:pass:p:0pL	PPRDXLPF
V:Part:DT-:pass:p:0pN	PPRDXNPF
V:Part:DT-:pass:p:fsA	PPRDFASF
V:Part:DT-:pass:p:fsD	PPRDFDSF
V:Part:DT-:pass:p:fsG	PPRDFGSF
V:Part:DT-:pass:p:fsI	PPRDFISF
V:Part:DT-:pass:p:fsL	PPRDFLSF
V:Part:DT-:pass:p:fsN	PPRDFNSF
V:Part:DT-:pass:p:msA	PPRDMASF
V:Part:DT-:pass:p:msD	PPRDMDSF
V:Part:DT-:pass:p:msG	PPRDMGSF
V:Part:DT-:pass:p:msI	PPRDMISF
V:Part:DT-:pass:p:msL	PPRDMLSF
V:Part:DT-:pass:p:msN	PPRDMNSF
V:Part:DT-:pass:p:nsA	PPRDNASF
V:Part:DT-:pass:p:nsD	PPRDNDSF
V:Part:DT-:pass:p:nsG	PPRDNGSF
V:Part:DT-:pass:p:nsI	PPRDNISF
V:Part:DT-:pass:p:nsL	PPRDNLSF
V:Part:DT-:pass:p:nsN	PPRDNNSF
	
V:Part:ID-:pass:p:0pA	PPRIXAPF
V:Part:ID-:pass:p:0pD	PPRIXDPF
V:Part:ID-:pass:p:0pG	PPRIXGPF
V:Part:ID-:pass:p:0pI	PPRIXIPF
V:Part:ID-:pass:p:0pL	PPRIXLPF
V:Part:ID-:pass:p:0pN	PPRIXNPF
V:Part:ID-:pass:p:fsA	PPRIFASF
V:Part:ID-:pass:p:fsD	PPRIFDSF
V:Part:ID-:pass:p:fsG	PPRIFGSF
V:Part:ID-:pass:p:fsI	PPRIFISF
V:Part:ID-:pass:p:fsL	PPRIFLSF
V:Part:ID-:pass:p:fsN	PPRIFNSF
V:Part:ID-:pass:p:msA	PPRIMASF
V:Part:ID-:pass:p:msD	PPRIMDSF
V:Part:ID-:pass:p:msG	PPRIMGSF
V:Part:ID-:pass:p:msI	PPRIMISF
V:Part:ID-:pass:p:msL	PPRIMLSF
V:Part:ID-:pass:p:msN	PPRIMNSF
V:Part:ID-:pass:p:nsA	PPRINASF
V:Part:ID-:pass:p:nsD	PPRINDSF
V:Part:ID-:pass:p:nsG	PPRINGSF
V:Part:ID-:pass:p:nsI	PPRINISF
V:Part:ID-:pass:p:nsL	PPRINLSF
V:Part:ID-:pass:p:nsN	PPRINNSF
	
V:Part:II-:pass:p:0pA	PPRIXAPF
V:Part:II-:pass:p:0pD	PPRIXDPF
V:Part:II-:pass:p:0pG	PPRIXGPF
V:Part:II-:pass:p:0pI	PPRIXIPF
V:Part:II-:pass:p:0pL	PPRIXLPF
V:Part:II-:pass:p:0pN	PPRIXNPF
V:Part:II-:pass:p:fsA	PPRIFASF
V:Part:II-:pass:p:fsD	PPRIFDSF
V:Part:II-:pass:p:fsG	PPRIFGSF
V:Part:II-:pass:p:fsI	PPRIFISF
V:Part:II-:pass:p:fsL	PPRIFLSF
V:Part:II-:pass:p:fsN	PPRIFNSF
V:Part:II-:pass:p:msA	PPRIMASF
V:Part:II-:pass:p:msD	PPRIMDSF
V:Part:II-:pass:p:msG	PPRIMGSF
V:Part:II-:pass:p:msI	PPRIMISF
V:Part:II-:pass:p:msL	PPRIMLSF
V:Part:II-:pass:p:msN	PPRIMNSF
V:Part:II-:pass:p:nsA	PPRINASF
V:Part:II-:pass:p:nsD	PPRINDSF
V:Part:II-:pass:p:nsG	PPRINGSF
V:Part:II-:pass:p:nsI	PPRINISF
V:Part:II-:pass:p:nsL	PPRINLSF
V:Part:II-:pass:p:nsN	PPRINNSF
	
V:Part:IT-:pass:p:0pA	PPRIXAPF
V:Part:IT-:pass:p:0pD	PPRIXDPF
V:Part:IT-:pass:p:0pG	PPRIXGPF
V:Part:IT-:pass:p:0pI	PPRIXIPF
V:Part:IT-:pass:p:0pL	PPRIXLPF
V:Part:IT-:pass:p:0pN	PPRIXNPF
V:Part:IT-:pass:p:fsA	PPRIFASF
V:Part:IT-:pass:p:fsD	PPRIFDSF
V:Part:IT-:pass:p:fsG	PPRIFGSF
V:Part:IT-:pass:p:fsI	PPRIFISF
V:Part:IT-:pass:p:fsL	PPRIFLSF
V:Part:IT-:pass:p:fsN	PPRIFNSF
V:Part:IT-:pass:p:msA	PPRIMASF
V:Part:IT-:pass:p:msD	PPRIMDSF
V:Part:IT-:pass:p:msG	PPRIMGSF
V:Part:IT-:pass:p:msI	PPRIMISF
V:Part:IT-:pass:p:msL	PPRIMLSF
V:Part:IT-:pass:p:msN	PPRIMNSF
V:Part:IT-:pass:p:nsA	PPRINASF
V:Part:IT-:pass:p:nsD	PPRINDSF
V:Part:IT-:pass:p:nsG	PPRINGSF
V:Part:IT-:pass:p:nsI	PPRINISF
V:Part:IT-:pass:p:nsL	PPRINLSF
V:Part:IT-:pass:p:nsN	PPRINNSF

V:Part:PT-:pass:p:0pA	PPRPXAPF
V:Part:PT-:pass:p:0pD	PPRPXDPF
V:Part:PT-:pass:p:0pG	PPRPXGPF
V:Part:PT-:pass:p:0pI	PPRPXIPF
V:Part:PT-:pass:p:0pL	PPRPXLPF
V:Part:PT-:pass:p:0pN	PPRPXNPF
V:Part:PT-:pass:p:fsA	PPRPFASF
V:Part:PT-:pass:p:fsD	PPRPFDSF
V:Part:PT-:pass:p:fsG	PPRPFGSF
V:Part:PT-:pass:p:fsI	PPRPFISF
V:Part:PT-:pass:p:fsL	PPRPFLSF
V:Part:PT-:pass:p:fsN	PPRPFNSF
V:Part:PT-:pass:p:msA	PPRPMASF
V:Part:PT-:pass:p:msD	PPRPMDSF
V:Part:PT-:pass:p:msG	PPRPMGSF
V:Part:PT-:pass:p:msI	PPRPMISF
V:Part:PT-:pass:p:msL	PPRPMLSF
V:Part:PT-:pass:p:msN	PPRPMNSF
V:Part:PT-:pass:p:nsA	PPRPNASF
V:Part:PT-:pass:p:nsD	PPRPNDSF
V:Part:PT-:pass:p:nsG	PPRPNGSF
V:Part:PT-:pass:p:nsI	PPRPNISF
V:Part:PT-:pass:p:nsL	PPRPNLSF
V:Part:PT-:pass:p:nsN	PPRPNNSF

V:Part:DD-:pass:a:0pA	PPPDXAPF
V:Part:DD-:pass:a:0pD	PPPDXDPF
V:Part:DD-:pass:a:0pG	PPPDXGPF
V:Part:DD-:pass:a:0pI	PPPDXIPF
V:Part:DD-:pass:a:0pL	PPPDXLPF
V:Part:DD-:pass:a:0pN	PPPDXNPF
V:Part:DD-:pass:a:fsA	PPPDFASF
V:Part:DD-:pass:a:fsD	PPPDFDSF
V:Part:DD-:pass:a:fsG	PPPDFGSF
V:Part:DD-:pass:a:fsI	PPPDFISF
V:Part:DD-:pass:a:fsL	PPPDFLSF
V:Part:DD-:pass:a:fsN	PPPDFNSF
V:Part:DD-:pass:a:msA	PPPDMASF
V:Part:DD-:pass:a:msD	PPPDMDSF
V:Part:DD-:pass:a:msG	PPPDMGSF
V:Part:DD-:pass:a:msI	PPPDMISF
V:Part:DD-:pass:a:msL	PPPDMLSF
V:Part:DD-:pass:a:msN	PPPDMNSF
V:Part:DD-:pass:a:nsA	PPPDNASF
V:Part:DD-:pass:a:nsD	PPPDNDSF
V:Part:DD-:pass:a:nsG	PPPDNGSF
V:Part:DD-:pass:a:nsI	PPPDNISF
V:Part:DD-:pass:a:nsL	PPPDNLSF
V:Part:DD-:pass:a:nsN	PPPDNNSF
	
V:Part:DI-:pass:a:0pA	PPPDXAPF
V:Part:DI-:pass:a:0pD	PPPDXDPF
V:Part:DI-:pass:a:0pG	PPPDXGPF
V:Part:DI-:pass:a:0pI	PPPDXIPF
V:Part:DI-:pass:a:0pL	PPPDXLPF
V:Part:DI-:pass:a:0pN	PPPDXNPF
V:Part:DI-:pass:a:fsA	PPPDFASF
V:Part:DI-:pass:a:fsD	PPPDFDSF
V:Part:DI-:pass:a:fsG	PPPDFGSF
V:Part:DI-:pass:a:fsI	PPPDFISF
V:Part:DI-:pass:a:fsL	PPPDFLSF
V:Part:DI-:pass:a:fsN	PPPDFNSF
V:Part:DI-:pass:a:msA	PPPDMASF
V:Part:DI-:pass:a:msD	PPPDMDSF
V:Part:DI-:pass:a:msG	PPPDMGSF
V:Part:DI-:pass:a:msI	PPPDMISF
V:Part:DI-:pass:a:msL	PPPDMLSF
V:Part:DI-:pass:a:msN	PPPDMNSF
V:Part:DI-:pass:a:nsA	PPPDNASF
V:Part:DI-:pass:a:nsD	PPPDNDSF
V:Part:DI-:pass:a:nsG	PPPDNGSF
V:Part:DI-:pass:a:nsI	PPPDNISF
V:Part:DI-:pass:a:nsL	PPPDNLSF
V:Part:DI-:pass:a:nsN	PPPDNNSF
	
V:Part:DT-:pass:a:0pA	PPPDXAPF
V:Part:DT-:pass:a:0pD	PPPDXDPF
V:Part:DT-:pass:a:0pG	PPPDXGPF
V:Part:DT-:pass:a:0pI	PPPDXIPF
V:Part:DT-:pass:a:0pL	PPPDXLPF
V:Part:DT-:pass:a:0pN	PPPDXNPF
V:Part:DT-:pass:a:fsA	PPPDFASF
V:Part:DT-:pass:a:fsD	PPPDFDSF
V:Part:DT-:pass:a:fsG	PPPDFGSF
V:Part:DT-:pass:a:fsI	PPPDFISF
V:Part:DT-:pass:a:fsL	PPPDFLSF
V:Part:DT-:pass:a:fsN	PPPDFNSF
V:Part:DT-:pass:a:msA	PPPDMASF
V:Part:DT-:pass:a:msD	PPPDMDSF
V:Part:DT-:pass:a:msG	PPPDMGSF
V:Part:DT-:pass:a:msI	PPPDMISF
V:Part:DT-:pass:a:msL	PPPDMLSF
V:Part:DT-:pass:a:msN	PPPDMNSF
V:Part:DT-:pass:a:nsA	PPPDNASF
V:Part:DT-:pass:a:nsD	PPPDNDSF
V:Part:DT-:pass:a:nsG	PPPDNGSF
V:Part:DT-:pass:a:nsI	PPPDNISF
V:Part:DT-:pass:a:nsL	PPPDNLSF
V:Part:DT-:pass:a:nsN	PPPDNNSF
	
V:Part:ID-:pass:a:0pA	PPPIXAPF
V:Part:ID-:pass:a:0pD	PPPIXDPF
V:Part:ID-:pass:a:0pG	PPPIXGPF
V:Part:ID-:pass:a:0pI	PPPIXIPF
V:Part:ID-:pass:a:0pL	PPPIXLPF
V:Part:ID-:pass:a:0pN	PPPIXNPF
V:Part:ID-:pass:a:fsA	PPPIFASF
V:Part:ID-:pass:a:fsD	PPPIFDSF
V:Part:ID-:pass:a:fsG	PPPIFGSF
V:Part:ID-:pass:a:fsI	PPPIFISF
V:Part:ID-:pass:a:fsL	PPPIFLSF
V:Part:ID-:pass:a:fsN	PPPIFNSF
V:Part:ID-:pass:a:msA	PPPIMASF
V:Part:ID-:pass:a:msD	PPPIMDSF
V:Part:ID-:pass:a:msG	PPPIMGSF
V:Part:ID-:pass:a:msI	PPPIMISF
V:Part:ID-:pass:a:msL	PPPIMLSF
V:Part:ID-:pass:a:msN	PPPIMNSF
V:Part:ID-:pass:a:nsA	PPPINASF
V:Part:ID-:pass:a:nsD	PPPINDSF
V:Part:ID-:pass:a:nsG	PPPINGSF
V:Part:ID-:pass:a:nsI	PPPINISF
V:Part:ID-:pass:a:nsL	PPPINLSF
V:Part:ID-:pass:a:nsN	PPPINNSF
	
V:Part:II-:pass:a:0pA	PPPIXAPF
V:Part:II-:pass:a:0pD	PPPIXDPF
V:Part:II-:pass:a:0pG	PPPIXGPF
V:Part:II-:pass:a:0pI	PPPIXIPF
V:Part:II-:pass:a:0pL	PPPIXLPF
V:Part:II-:pass:a:0pN	PPPIXNPF
V:Part:II-:pass:a:fsA	PPPIFASF
V:Part:II-:pass:a:fsD	PPPIFDSF
V:Part:II-:pass:a:fsG	PPPIFGSF
V:Part:II-:pass:a:fsI	PPPIFISF
V:Part:II-:pass:a:fsL	PPPIFLSF
V:Part:II-:pass:a:fsN	PPPIFNSF
V:Part:II-:pass:a:msA	PPPIMASF
V:Part:II-:pass:a:msD	PPPIMDSF
V:Part:II-:pass:a:msG	PPPIMGSF
V:Part:II-:pass:a:msI	PPPIMISF
V:Part:II-:pass:a:msL	PPPIMLSF
V:Part:II-:pass:a:msN	PPPIMNSF
V:Part:II-:pass:a:nsA	PPPINASF
V:Part:II-:pass:a:nsD	PPPINDSF
V:Part:II-:pass:a:nsG	PPPINGSF
V:Part:II-:pass:a:nsI	PPPINISF
V:Part:II-:pass:a:nsL	PPPINLSF
V:Part:II-:pass:a:nsN	PPPINNSF
	
V:Part:IT-:pass:a:0pA	PPPIXAPF
V:Part:IT-:pass:a:0pD	PPPIXDPF
V:Part:IT-:pass:a:0pG	PPPIXGPF
V:Part:IT-:pass:a:0pI	PPPIXIPF
V:Part:IT-:pass:a:0pL	PPPIXLPF
V:Part:IT-:pass:a:0pN	PPPIXNPF
V:Part:IT-:pass:a:fsA	PPPIFASF
V:Part:IT-:pass:a:fsD	PPPIFDSF
V:Part:IT-:pass:a:fsG	PPPIFGSF
V:Part:IT-:pass:a:fsI	PPPIFISF
V:Part:IT-:pass:a:fsL	PPPIFLSF
V:Part:IT-:pass:a:fsN	PPPIFNSF
V:Part:IT-:pass:a:msA	PPPIMASF
V:Part:IT-:pass:a:msD	PPPIMDSF
V:Part:IT-:pass:a:msG	PPPIMGSF
V:Part:IT-:pass:a:msI	PPPIMISF
V:Part:IT-:pass:a:msL	PPPIMLSF
V:Part:IT-:pass:a:msN	PPPIMNSF
V:Part:IT-:pass:a:nsA	PPPINASF
V:Part:IT-:pass:a:nsD	PPPINDSF
V:Part:IT-:pass:a:nsG	PPPINGSF
V:Part:IT-:pass:a:nsI	PPPINISF
V:Part:IT-:pass:a:nsL	PPPINLSF
V:Part:IT-:pass:a:nsN	PPPINNSF
	
V:Part:PD-:pass:a:0pA	PPPPXAPF
V:Part:PD-:pass:a:0pD	PPPPXDPF
V:Part:PD-:pass:a:0pG	PPPPXGPF
V:Part:PD-:pass:a:0pI	PPPPXIPF
V:Part:PD-:pass:a:0pL	PPPPXLPF
V:Part:PD-:pass:a:0pN	PPPPXNPF
V:Part:PD-:pass:a:fsA	PPPPFASF
V:Part:PD-:pass:a:fsD	PPPPFDSF
V:Part:PD-:pass:a:fsG	PPPPFGSF
V:Part:PD-:pass:a:fsI	PPPPFISF
V:Part:PD-:pass:a:fsL	PPPPFLSF
V:Part:PD-:pass:a:fsN	PPPPFNSF
V:Part:PD-:pass:a:msA	PPPPMASF
V:Part:PD-:pass:a:msD	PPPPMDSF
V:Part:PD-:pass:a:msG	PPPPMGSF
V:Part:PD-:pass:a:msI	PPPPMISF
V:Part:PD-:pass:a:msL	PPPPMLSF
V:Part:PD-:pass:a:msN	PPPPMNSF
V:Part:PD-:pass:a:nsA	PPPPNASF
V:Part:PD-:pass:a:nsD	PPPPNDSF
V:Part:PD-:pass:a:nsG	PPPPNGSF
V:Part:PD-:pass:a:nsI	PPPPNISF
V:Part:PD-:pass:a:nsL	PPPPNLSF
V:Part:PD-:pass:a:nsN	PPPPNNSF
	
V:Part:PI-:pass:a:0pA	PPPPXAPF
V:Part:PI-:pass:a:0pD	PPPPXDPF
V:Part:PI-:pass:a:0pG	PPPPXGPF
V:Part:PI-:pass:a:0pI	PPPPXIPF
V:Part:PI-:pass:a:0pL	PPPPXLPF
V:Part:PI-:pass:a:0pN	PPPPXNPF
V:Part:PI-:pass:a:fsA	PPPPFASF
V:Part:PI-:pass:a:fsD	PPPPFDSF
V:Part:PI-:pass:a:fsG	PPPPFGSF
V:Part:PI-:pass:a:fsI	PPPPFISF
V:Part:PI-:pass:a:fsL	PPPPFLSF
V:Part:PI-:pass:a:fsN	PPPPFNSF
V:Part:PI-:pass:a:msA	PPPPMASF
V:Part:PI-:pass:a:msD	PPPPMDSF
V:Part:PI-:pass:a:msG	PPPPMGSF
V:Part:PI-:pass:a:msI	PPPPMISF
V:Part:PI-:pass:a:msL	PPPPMLSF
V:Part:PI-:pass:a:msN	PPPPMNSF
V:Part:PI-:pass:a:nsA	PPPPNASF
V:Part:PI-:pass:a:nsD	PPPPNDSF
V:Part:PI-:pass:a:nsG	PPPPNGSF
V:Part:PI-:pass:a:nsI	PPPPNISF
V:Part:PI-:pass:a:nsL	PPPPNLSF
V:Part:PI-:pass:a:nsN	PPPPNNSF
	
V:Part:PT-:pass:a:0pA	PPPPXAPF
V:Part:PT-:pass:a:0pD	PPPPXDPF
V:Part:PT-:pass:a:0pG	PPPPXGPF
V:Part:PT-:pass:a:0pI	PPPPXIPF
V:Part:PT-:pass:a:0pL	PPPPXLPF
V:Part:PT-:pass:a:0pN	PPPPXNPF
V:Part:PT-:pass:a:fsA	PPPPFASF
V:Part:PT-:pass:a:fsD	PPPPFDSF
V:Part:PT-:pass:a:fsG	PPPPFGSF
V:Part:PT-:pass:a:fsI	PPPPFISF
V:Part:PT-:pass:a:fsL	PPPPFLSF
V:Part:PT-:pass:a:fsN	PPPPFNSF
V:Part:PT-:pass:a:msA	PPPPMASF
V:Part:PT-:pass:a:msD	PPPPMDSF
V:Part:PT-:pass:a:msG	PPPPMGSF
V:Part:PT-:pass:a:msI	PPPPMISF
V:Part:PT-:pass:a:msL	PPPPMLSF
V:Part:PT-:pass:a:msN	PPPPMNSF
V:Part:PT-:pass:a:nsA	PPPPNASF
V:Part:PT-:pass:a:nsD	PPPPNDSF
V:Part:PT-:pass:a:nsG	PPPPNGSF
V:Part:PT-:pass:a:nsI	PPPPNISF
V:Part:PT-:pass:a:nsL	PPPPNLSF
V:Part:PT-:pass:a:nsN	PPPPNNSF

V:Part:DD-:pass:fs:sh	PPXDFNSS
V:Part:DD-:pass:ms:sh	PPXDMNSS
V:Part:DD-:pass:ns:sh	PPXDNNSS
V:Part:DD-:pass:0p:sh	PPXDXNPS
	
V:Part:DI-:pass:fs:sh	PPXDFNSS
V:Part:DI-:pass:ms:sh	PPXDMNSS
V:Part:DI-:pass:ns:sh	PPXDNNSS
V:Part:DI-:pass:0p:sh	PPXDXNPS
	
V:Part:DT-:pass:fs:sh	PPXDFNSS
V:Part:DT-:pass:ms:sh	PPXDMNSS
V:Part:DT-:pass:ns:sh	PPXDNNSS
V:Part:DT-:pass:0p:sh	PPXDXNPS
	
V:Part:ID-:pass:fs:sh	PPXIFNSS
V:Part:ID-:pass:ms:sh	PPXIMNSS
V:Part:ID-:pass:ns:sh	PPXINNSS
V:Part:ID-:pass:0p:sh	PPXIXNPS
	
V:Part:II-:pass:fs:sh	PPXIFNSS
V:Part:II-:pass:ms:sh	PPXIMNSS
V:Part:II-:pass:ns:sh	PPXINNSS
V:Part:II-:pass:0p:sh	PPXIXNPS
	
V:Part:IT-:pass:fs:sh	PPXIFNSS
V:Part:IT-:pass:ms:sh	PPXIMNSS
V:Part:IT-:pass:ns:sh	PPXINNSS
V:Part:IT-:pass:0p:sh	PPXIXNPS
	
V:Part:PD-:pass:fs:sh	PPXPFNSS
V:Part:PD-:pass:ms:sh	PPXPMNSS
V:Part:PD-:pass:ns:sh	PPXPNNSS
V:Part:PD-:pass:0p:sh	PPXPXNPS
	
V:Part:PI-:pass:fs:sh	PPXPFNSS
V:Part:PI-:pass:ms:sh	PPXPMNSS
V:Part:PI-:pass:ns:sh	PPXPNNSS
V:Part:PI-:pass:0p:sh	PPXPXNPS
	
V:Part:PT-:pass:fs:sh	PPXPFNSS
V:Part:PT-:pass:ms:sh	PPXPMNSS
V:Part:PT-:pass:ns:sh	PPXPNNSS
V:Part:PT-:pass:0p:sh	PPXPXNPS

V:Part:DD-:pass:a:fs:sh	PPPDFNSS
V:Part:DD-:pass:a:ms:sh	PPPDMNSS
V:Part:DD-:pass:a:ns:sh	PPPDNNSS
V:Part:DD-:pass:a:0p:sh	PPPDXNPS
	
V:Part:DI-:pass:a:fs:sh	PPPDFNSS
V:Part:DI-:pass:a:ms:sh	PPPDMNSS
V:Part:DI-:pass:a:ns:sh	PPPDNNSS
V:Part:DI-:pass:a:0p:sh	PPPDXNPS
	
V:Part:DT-:pass:a:fs:sh	PPPDFNSS
V:Part:DT-:pass:a:ms:sh	PPPDMNSS
V:Part:DT-:pass:a:ns:sh	PPPDNNSS
V:Part:DT-:pass:a:0p:sh	PPPDXNPS
	
V:Part:ID-:pass:a:fs:sh	PPPIFNSS
V:Part:ID-:pass:a:ms:sh	PPPIMNSS
V:Part:ID-:pass:a:ns:sh	PPPINNSS
V:Part:ID-:pass:a:0p:sh	PPPIXNPS
	
V:Part:II-:pass:a:fs:sh	PPPIFNSS
V:Part:II-:pass:a:ms:sh	PPPIMNSS
V:Part:II-:pass:a:ns:sh	PPPINNSS
V:Part:II-:pass:a:0p:sh	PPPIXNPS
	
V:Part:IT-:pass:a:fs:sh	PPPIFNSS
V:Part:IT-:pass:a:ms:sh	PPPIMNSS
V:Part:IT-:pass:a:ns:sh	PPPINNSS
V:Part:IT-:pass:a:0p:sh	PPPIXNPS
	
V:Part:PD-:pass:a:fs:sh	PPPPFNSS
V:Part:PD-:pass:a:ms:sh	PPPPMNSS
V:Part:PD-:pass:a:ns:sh	PPPPNNSS
V:Part:PD-:pass:a:0p:sh	PPPPXNPS
	
V:Part:PI-:pass:a:fs:sh	PPPPFNSS
V:Part:PI-:pass:a:ms:sh	PPPPMNSS
V:Part:PI-:pass:a:ns:sh	PPPPNNSS
V:Part:PI-:pass:a:0p:sh	PPPPXNPS
	
V:Part:PT-:pass:a:fs:sh	PPPPFNSS
V:Part:PT-:pass:a:ms:sh	PPPPMNSS
V:Part:PT-:pass:a:ns:sh	PPPPNNSS
V:Part:PT-:pass:a:0p:sh	PPPPXNPS

V:Part:DD-:pass:p:fs:sh	PPRDFNSS
V:Part:DD-:pass:p:ms:sh	PPRDMNSS
V:Part:DD-:pass:p:ns:sh	PPRDNNSS
V:Part:DD-:pass:p:0p:sh	PPRDXNPS
	
V:Part:DI-:pass:p:fs:sh	PPRDFNSS
V:Part:DI-:pass:p:ms:sh	PPRDMNSS
V:Part:DI-:pass:p:ns:sh	PPRDNNSS
V:Part:DI-:pass:p:0p:sh	PPRDXNPS
	
V:Part:DT-:pass:p:fs:sh	PPRDFNSS
V:Part:DT-:pass:p:ms:sh	PPRDMNSS
V:Part:DT-:pass:p:ns:sh	PPRDNNSS
V:Part:DT-:pass:p:0p:sh	PPRDXNPS
	
V:Part:ID-:pass:p:fs:sh	PPRIFNSS
V:Part:ID-:pass:p:ms:sh	PPRIMNSS
V:Part:ID-:pass:p:ns:sh	PPRINNSS
V:Part:ID-:pass:p:0p:sh	PPRIXNPS
	
V:Part:II-:pass:p:fs:sh	PPRIFNSS
V:Part:II-:pass:p:ms:sh	PPRIMNSS
V:Part:II-:pass:p:ns:sh	PPRINNSS
V:Part:II-:pass:p:0p:sh	PPRIXNPS
	
V:Part:IT-:pass:p:fs:sh	PPRIFNSS
V:Part:IT-:pass:p:ms:sh	PPRIMNSS
V:Part:IT-:pass:p:ns:sh	PPRINNSS
V:Part:IT-:pass:p:0p:sh	PPRIXNPS
	
V:Part:PD-:pass:p:fs:sh	PPRPFNSS
V:Part:PD-:pass:p:ms:sh	PPRPMNSS
V:Part:PD-:pass:p:ns:sh	PPRPNNSS
V:Part:PD-:pass:p:0p:sh	PPRPXNPS
	
V:Part:PI-:pass:p:fs:sh	PPRPFNSS
V:Part:PI-:pass:p:ms:sh	PPRPMNSS
V:Part:PI-:pass:p:ns:sh	PPRPNNSS
V:Part:PI-:pass:p:0p:sh	PPRPXNPS
	
V:Part:PT-:pass:p:fs:sh	PPRPFNSS
V:Part:PT-:pass:p:ms:sh	PPRPMNSS
V:Part:PT-:pass:p:ns:sh	PPRPNNSS
V:Part:PT-:pass:p:0p:sh	PPRPXNPS

# Прилагательное

Adj:Abbr	AXPXXXX

Adj:0pA	AXPXAPF
Adj:0pD	AXPXDPF
Adj:0pG	AXPXGPF
Adj:0pI	AXPXIPF
Adj:0pL	AXPXLPF
Adj:0pN	AXPXNPF
	
Adj:fsA	AXPFASF
Adj:fsD	AXPFDSF
Adj:fsG	AXPFGSF
Adj:fsI	AXPFISF
Adj:fsL	AXPFLSF
Adj:fsN	AXPFNSF
	
Adj:msA	AXPMASF
Adj:msD	AXPMDSF
Adj:msG	AXPMGSF
Adj:msI	AXPMISF
Adj:msL	AXPMLSF
Adj:msN	AXPMNSF
	
Adj:nsA	AXPNASF
Adj:nsD	AXPNDSF
Adj:nsG	AXPNGSF
Adj:nsI	AXPNISF
Adj:nsL	AXPNLSF
Adj:nsN	AXPNNSF

Adj:ms:sh	AQPMNSS
Adj:fs:sh	AQPFNSS
Adj:ns:sh	AQPNNSS
Adj:0p:sh	AQPXNPS

Adj:Comp	AQCXXXX
	
Adj:Comp:0pA	AQCXAPF
Adj:Comp:0pD	AQCXDPF
Adj:Comp:0pG	AQCXGPF
Adj:Comp:0pI	AQCXIPF
Adj:Comp:0pL	AQCXLPF
Adj:Comp:0pN	AQCXNPF
	
Adj:Comp:fsA	AQCFASF
Adj:Comp:fsD	AQCFDSF
Adj:Comp:fsG	AQCFGSF
Adj:Comp:fsI	AQCFISF
Adj:Comp:fsL	AQCFLSF
Adj:Comp:fsN	AQCFNSF
	
Adj:Comp:msA	AQCMASF
Adj:Comp:msD	AQCMDSF
Adj:Comp:msG	AQCMGSF
Adj:Comp:msI	AQCMISF
Adj:Comp:msL	AQCMLSF
Adj:Comp:msN	AQCMNSF
	
Adj:Comp:nsA	AQCNASF
Adj:Comp:nsD	AQCNDSF
Adj:Comp:nsG	AQCNGSF
Adj:Comp:nsI	AQCNISF
Adj:Comp:nsL	AQCNLSF
Adj:Comp:nsN	AQCNNSF
	
Adj:Sup:0pA	AQSXAPF
Adj:Sup:0pD	AQSXDPF
Adj:Sup:0pG	AQSXGPF
Adj:Sup:0pI	AQSXIPF
Adj:Sup:0pL	AQSXLPF
Adj:Sup:0pN	AQSXNPF
	
Adj:Sup:fsA	AQSFASF
Adj:Sup:fsD	AQSFDSF
Adj:Sup:fsG	AQSFGSF
Adj:Sup:fsI	AQSFISF
Adj:Sup:fsL	AQSFLSF
Adj:Sup:fsN	AQSFNSF
	
Adj:Sup:msA	AQSMASF
Adj:Sup:msD	AQSMDSF
Adj:Sup:msG	AQSMGSF
Adj:Sup:msI	AQSMISF
Adj:Sup:msL	AQSMLSF
Adj:Sup:msN	AQSMNSF
	
Adj:Sup:nsA	AQSNASF
Adj:Sup:nsD	AQSNDSF
Adj:Sup:nsG	AQSNGSF
Adj:Sup:nsI	AQSNISF
Adj:Sup:nsL	AQSNLSF
Adj:Sup:nsN	AQSNNSF

# Числительное

NumCard	MXCXXX
NumCard:Abbr	MXCXXX

NumColl	MXKXXX

NumOrd:0pA	MAOXAP
NumOrd:0pD	MAOXDP
NumOrd:0pG	MAOXGP
NumOrd:0pI	MAOXIP
NumOrd:0pL	MAOXLP
NumOrd:0pN	MAOXNP

NumOrd:fsA	MAOFAS
NumOrd:fsD	MAOFDS
NumOrd:fsG	MAOFGS
NumOrd:fsI	MAOFIS
NumOrd:fsL	MAOFLS
NumOrd:fsN	MAOFNS

NumOrd:msA	MAOMAS
NumOrd:msD	MAOMDS
NumOrd:msG	MAOMGS
NumOrd:msI	MAOMIS
NumOrd:msL	MAOMLS
NumOrd:msN	MAOMNS

NumOrd:nsA	MAONAS
NumOrd:nsD	MAONDS
NumOrd:nsG	MAONGS
NumOrd:nsI	MAONIS
NumOrd:nsL	MAONLS
NumOrd:nsN	MAONNS

# Местоимение

Pron:pers:1:sA	SXP1XAS
Pron:pers:1:sD	SXP1XDS
Pron:pers:1:sG	SXP1XGS
Pron:pers:1:sI	SXP1XIS
Pron:pers:1:sL	SXP1XLS
Pron:pers:1:sN	SXP1XNS

Pron:pers:2:sA	SXP2XAS
Pron:pers:2:sD	SXP2XDS
Pron:pers:2:sG	SXP2XGS
Pron:pers:2:sI	SXP2XIS
Pron:pers:2:sL	SXP2XLS
Pron:pers:2:sN	SXP2XNS

Pron:pers:3:msA	SXP3MAS
Pron:pers:3:msD	SXP3MDS
Pron:pers:3:msG	SXP3MGS
Pron:pers:3:msI	SXP3MIS
Pron:pers:3:msL	SXP3MLS
Pron:pers:3:msN	SXP3MNS

Pron:pers:3:fsA	SXP3FAS
Pron:pers:3:fsD	SXP3FDS
Pron:pers:3:fsG	SXP3FGS
Pron:pers:3:fsI	SXP3FIS
Pron:pers:3:fsL	SXP3FLS
Pron:pers:3:fsN	SXP3FNS

Pron:pers:3:nsA	SXP3NAS
Pron:pers:3:nsD	SXP3NDS
Pron:pers:3:nsG	SXP3NGS
Pron:pers:3:nsI	SXP3NIS
Pron:pers:3:nsL	SXP3NLS
Pron:pers:3:nsN	SXP3NNS

Pron:pers:1:pA	SXP1XAP
Pron:pers:1:pD	SXP1XDP
Pron:pers:1:pG	SXP1XGP
Pron:pers:1:pI	SXP1XIP
Pron:pers:1:pL	SXP1XLP
Pron:pers:1:pN	SXP1XNP

Pron:pers:2:pA	SXP2XAP
Pron:pers:2:pD	SXP2XDP
Pron:pers:2:pG	SXP2XGP
Pron:pers:2:pI	SXP2XIP
Pron:pers:2:pL	SXP2XLP
Pron:pers:2:pN	SXP2XNP

Pron:pers:3:pA	SXP3XAP
Pron:pers:3:pD	SXP3XDP
Pron:pers:3:pG	SXP3XGP
Pron:pers:3:pI	SXP3XIP
Pron:pers:3:pL	SXP3XLP
Pron:pers:3:pN	SXP3XNP

Pron:dem:0pA	SADXXAP
Pron:dem:0pD	SADXXDP
Pron:dem:0pG	SADXXGP
Pron:dem:0pI	SADXXIP
Pron:dem:0pL	SADXXLP
Pron:dem:0pN	SADXXNP
	
Pron:dem:fsA	SADXFAS
Pron:dem:fsD	SADXFDS
Pron:dem:fsG	SADXFGS
Pron:dem:fsI	SADXFIS
Pron:dem:fsL	SADXFLS
Pron:dem:fsN	SADXFNS
	
Pron:dem:msA	SADXMAS
Pron:dem:msD	SADXMDS
Pron:dem:msG	SADXMGS
Pron:dem:msI	SADXMIS
Pron:dem:msL	SADXMLS
Pron:dem:msN	SADXMNS
	
Pron:dem:nsA	SADXNAS
Pron:dem:nsD	SADXNDS
Pron:dem:nsG	SADXNGS
Pron:dem:nsI	SADXNIS
Pron:dem:nsL	SADXNLS
Pron:dem:nsN	SADXNNS
	
Pron:dem:pA	SXDXXAP
Pron:dem:pD	SXDXXDP
Pron:dem:pG	SXDXXGP
Pron:dem:pI	SXDXXIP
Pron:dem:pL	SXDXXLP
Pron:dem:pN	SXDXXNP
	
Pron:det:0pA	SAEXXAP
Pron:det:0pD	SAEXXDP
Pron:det:0pG	SAEXXGP
Pron:det:0pI	SAEXXIP
Pron:det:0pL	SAEXXLP
Pron:det:0pN	SAEXXNP
	
Pron:det:fsA	SAEXFAS
Pron:det:fsD	SAEXFDS
Pron:det:fsG	SAEXFGS
Pron:det:fsI	SAEXFIS
Pron:det:fsL	SAEXFLS
Pron:det:fsN	SAEXFNS
	
Pron:det:msA	SAEXMAS
Pron:det:msD	SAEXMDS
Pron:det:msG	SAEXMGS
Pron:det:msI	SAEXMIS
Pron:det:msL	SAEXMLS
Pron:det:msN	SAEXMNS
	
Pron:det:nsA	SAEXNAS
Pron:det:nsD	SAEXNDS
Pron:det:nsG	SAEXNGS
Pron:det:nsI	SAEXNIS
Pron:det:nsL	SAEXNLS
Pron:det:nsN	SAEXNNS

Pron:det:0	SAEXXXX

Pron:ind:0pA	SAFXXAP
Pron:ind:0pD	SAFXXDP
Pron:ind:0pG	SAFXXGP
Pron:ind:0pI	SAFXXIP
Pron:ind:0pL	SAFXXLP
Pron:ind:0pN	SAFXXNP
	
Pron:ind:fsA	SAFXFAS
Pron:ind:fsD	SAFXFDS
Pron:ind:fsG	SAFXFGS
Pron:ind:fsI	SAFXFIS
Pron:ind:fsL	SAFXFLS
Pron:ind:fsN	SAFXFNS
	
Pron:ind:msA	SAFXMAS
Pron:ind:msD	SAFXMDS
Pron:ind:msG	SAFXMGS
Pron:ind:msI	SAFXMIS
Pron:ind:msL	SAFXMLS
Pron:ind:msN	SAFXMNS
	
Pron:ind:nsA	SAFXNAS
Pron:ind:nsD	SAFXNDS
Pron:ind:nsG	SAFXNGS
Pron:ind:nsI	SAFXNIS
Pron:ind:nsL	SAFXNLS
Pron:ind:nsN	SAFXNNS
	
Pron:ind:pA	SXFXXAP
Pron:ind:pD	SXFXXDP
Pron:ind:pG	SXFXXGP
Pron:ind:pI	SXFXXIP
Pron:ind:pL	SXFXXLP
Pron:ind:pN	SXFXXNP
	
Pron:ind:sA	SXFXXAS
Pron:ind:sD	SXFXXDS
Pron:ind:sG	SXFXXGS
Pron:ind:sI	SXFXXIS
Pron:ind:sL	SXFXXLS
Pron:ind:sN	SXFXXNS
	
Pron:neg:0pA	SANXXAP
Pron:neg:0pD	SANXXDP
Pron:neg:0pG	SANXXGP
Pron:neg:0pI	SANXXIP
Pron:neg:0pL	SANXXLP
Pron:neg:0pN	SANXXNP
	
Pron:neg:fsA	SANXFAS
Pron:neg:fsD	SANXFDS
Pron:neg:fsG	SANXFGS
Pron:neg:fsI	SANXFIS
Pron:neg:fsL	SANXFLS
Pron:neg:fsN	SANXFNS
	
Pron:neg:msA	SANXMAS
Pron:neg:msD	SANXMDS
Pron:neg:msG	SANXMGS
Pron:neg:msI	SANXMIS
Pron:neg:msL	SANXMLS
Pron:neg:msN	SANXMNS
	
Pron:neg:nsA	SANXNAS
Pron:neg:nsD	SANXNDS
Pron:neg:nsG	SANXNGS
Pron:neg:nsI	SANXNIS
Pron:neg:nsL	SANXNLS
Pron:neg:nsN	SANXNNS
	
Pron:neg:sA	SXNXXAS
Pron:neg:sD	SXNXXDS
Pron:neg:sG	SXNXXGS
Pron:neg:sI	SXNXXIS
Pron:neg:sL	SXNXXLS
Pron:neg:sN	SXNXXNS

Pron:poss:0	SXSXXXX
	
Pron:poss:0pA	SASXXAP
Pron:poss:0pD	SASXXDP
Pron:poss:0pG	SASXXGP
Pron:poss:0pI	SASXXIP
Pron:poss:0pL	SASXXLP
Pron:poss:0pN	SASXXNP
	
Pron:poss:fsA	SASXFAS
Pron:poss:fsD	SASXFDS
Pron:poss:fsG	SASXFGS
Pron:poss:fsI	SASXFIS
Pron:poss:fsL	SASXFLS
Pron:poss:fsN	SASXFNS
	
Pron:poss:msA	SASXMAS
Pron:poss:msD	SASXMDS
Pron:poss:msG	SASXMGS
Pron:poss:msI	SASXMIS
Pron:poss:msL	SASXMLS
Pron:poss:msN	SASXMNS
	
Pron:poss:nsA	SASXNAS
Pron:poss:nsD	SASXNDS
Pron:poss:nsG	SASXNGS
Pron:poss:nsI	SASXNIS
Pron:poss:nsL	SASXNLS
Pron:poss:nsN	SASXNNS

Pron:refl:sA	SXRXXAS
Pron:refl:sD	SXRXXDS
Pron:refl:sG	SXRXXGS
Pron:refl:sI	SXRXXIS
Pron:refl:sL	SXRXXLS
	
Pron:rel:0pA	SALXXAP
Pron:rel:0pD	SALXXDP
Pron:rel:0pG	SALXXGP
Pron:rel:0pI	SALXXIP
Pron:rel:0pL	SALXXLP
Pron:rel:0pN	SALXXNP
	
Pron:rel:fsA	SALXFAS
Pron:rel:fsD	SALXFDS
Pron:rel:fsG	SALXFGS
Pron:rel:fsI	SALXFIS
Pron:rel:fsL	SALXFLS
Pron:rel:fsN	SALXFNS
	
Pron:rel:msA	SALXMAS
Pron:rel:msD	SALXMDS
Pron:rel:msG	SALXMGS
Pron:rel:msI	SALXMIS
Pron:rel:msL	SALXMLS
Pron:rel:msN	SALXMNS
	
Pron:rel:nsA	SALXNAS
Pron:rel:nsD	SALXNDS
Pron:rel:nsG	SALXNGS
Pron:rel:nsI	SALXNIS
Pron:rel:nsL	SALXNLS
Pron:rel:nsN	SALXNNS
	
Pron:rel:pA	SXLXXAP
Pron:rel:pD	SXLXXDP
Pron:rel:pG	SXLXXGP
Pron:rel:pI	SXLXXIP
Pron:rel:pL	SXLXXLP
Pron:rel:pN	SXLXXNP
	
Pron:rel:sA	SXLXXAS
Pron:rel:sD	SXLXXDS
Pron:rel:sG	SXLXXGS
Pron:rel:sI	SXLXXIS
Pron:rel:sL	SXLXXLS
Pron:rel:sN	SXLXXNS

# Наречие

Adv	RP
Adv:Comp	RC
Adv:Sup	RS

# Предикативное слово

Pred	W

# Предлог

Prep	I

# Союз

Conj:coord	CK
Conj:sub	CS

# Частица

Pcle	E
Postfix	E

# Модальное слово

Mod	Z

# Междометие

Excl	Y

# Знак препинания

Punc	PM
Symb	PM:Symb
Tag	PM:Symb